,Player,Nation,Pos,Squad,Comp,Age,Born,90s,Tkl,TklW,Def 3rd,Mid 3rd,Att 3rd,Tkl,Att,Tkl%,Lost,Blocks,Sh,Pass,Int,Tkl+Int,Clr,Err
0,Max Aarons,ENG,DF,Bournemouth,eng  Premier League,25-066,2000.0,1.0,2,2,1,1,0,1,1,100.0,0,3,1,2,1,3,0,0
1,Max Aarons,ENG,MF,Valencia,es  La Liga,25-066,2000.0,0.3,1,1,0,1,0,1,1,100.0,0,1,0,1,0,1,0,0
2,Rodrigo Abajas,ESP,DF,Valencia,es  La Liga,21-303,2003.0,0.7,3,2,2,1,0,3,3,100.0,0,1,0,1,1,4,0,0
3,James Abankwah,IRL,"DF,MF",Udinese,it  Serie A,21-054,2004.0,1.0,4,2,4,0,0,2,3,66.7,1,2,1,1,1,5,3,0
4,Keyliane Abdallah,FRA,FW,Marseille,fr  Ligue 1,18-340,2006.0,0.0,1,1,1,0,0,1,1,100.0,0,0,0,0,0,1,0,0
5,Yunis Abdelhamid,MAR,DF,Saint-Étienne,fr  Ligue 1,37-164,1987.0,10.8,17,11,15,2,0,10,16,62.5,6,24,17,7,13,30,56,1
6,Himad Abdelli,ALG,"MF,FW",Angers,fr  Ligue 1,25-114,1999.0,23.7,35,24,8,15,12,11,33,33.3,22,16,0,16,18,53,19,1
7,Mohamed Abdelmoneim,EGY,DF,Nice,fr  Ligue 1,26-038,1999.0,6.8,17,12,11,5,1,11,18,61.1,7,6,3,3,13,30,39,1
8,Ali Abdi,TUN,"DF,MF",Nice,fr  Ligue 1,31-081,1993.0,10.5,25,16,10,9,6,19,31,61.3,12,17,4,13,11,36,28,0
9,Saud Abdulhamid,KSA,DF,Roma,it  Serie A,25-236,1999.0,2.3,3,2,2,0,1,1,1,100.0,0,2,0,2,2,5,0,0
10,Abel,ESP,DF,Osasuna,es  La Liga,24-202,2000.0,16.4,38,26,15,16,7,22,37,59.5,15,22,2,20,13,51,46,2
11,Nabil Aberdin,FRA,MF,Getafe,es  La Liga,22-200,2002.0,2.9,6,4,3,3,0,1,1,100.0,0,3,0,3,0,6,5,0
12,Oliver Abildgaard,DEN,MF,Como,it  Serie A,28-274,1996.0,0.1,0,0,0,0,0,0,0,,0,1,0,1,0,0,0,0
13,Matthis Abline,FRA,FW,Nantes,fr  Ligue 1,21-348,2003.0,22.1,10,4,2,4,4,3,9,33.3,6,10,0,10,2,12,26,1
14,Abner,BRA,DF,Lyon,fr  Ligue 1,24-288,2000.0,9.1,20,14,9,8,3,15,23,65.2,8,12,1,11,5,25,32,0
15,Zakaria Aboukhlal,MAR,"MF,FW",Toulouse,fr  Ligue 1,25-021,2000.0,20.3,19,11,6,7,6,4,21,19.0,17,16,1,15,6,25,8,0
16,Abdel Abqar,MAR,DF,Alavés,es  La Liga,26-001,1999.0,23.5,31,20,20,10,1,18,29,62.1,11,22,15,7,36,67,124,1
17,Tammy Abraham,ENG,FW,Roma,it  Serie A,27-160,1997.0,0.0,0,0,0,0,0,0,1,0.0,1,0,0,0,0,0,0,0
18,Tammy Abraham,ENG,FW,Milan,it  Serie A,27-160,1997.0,10.6,14,10,1,9,4,5,7,71.4,2,9,0,9,2,16,8,0
19,Federico Accornero,ITA,MF,Genoa,it  Serie A,21-034,2004.0,0.1,0,0,0,0,0,0,0,,0,0,0,0,0,0,0,0
20,Francesco Acerbi,ITA,DF,Inter,it  Serie A,37-029,1988.0,12.4,15,12,9,6,0,6,9,66.7,3,14,10,4,19,34,55,0
21,Joshua Acheampong,ENG,DF,Chelsea,eng  Premier League,18-310,2006.0,1.9,2,1,2,0,0,2,2,100.0,0,1,0,1,1,3,2,0
22,Akor Adams,NGA,FW,Sevilla,es  La Liga,25-041,2000.0,0.1,0,0,0,0,0,0,0,,0,0,0,0,0,0,1,0
23,Akor Adams,NGA,FW,Montpellier,fr  Ligue 1,25-041,2000.0,11.9,4,3,1,2,1,3,4,75.0,1,2,1,1,1,5,5,1
24,Che Adams,SCO,FW,Torino,it  Serie A,28-241,1996.0,20.3,8,3,1,3,4,0,4,0.0,4,8,4,4,1,9,14,0
25,Tyler Adams,USA,MF,Bournemouth,eng  Premier League,26-025,1999.0,13.0,60,38,19,35,6,24,46,52.2,22,18,6,12,28,88,26,0
26,Junior Adamu,AUT,FW,Freiburg,de  Bundesliga,23-278,2001.0,11.6,3,0,1,1,1,0,5,0.0,5,11,0,11,8,11,13,0
27,Tosin Adarabioyo,ENG,DF,Chelsea,eng  Premier League,27-168,1997.0,12.1,14,10,10,4,0,8,12,66.7,4,7,6,1,9,23,52,0
28,Martin Adeline,FRA,MF,Reims,fr  Ligue 1,21-099,2003.0,0.3,1,1,0,1,0,1,2,50.0,1,0,0,0,0,1,2,0
29,Karim Adeyemi,GER,"FW,MF",Dortmund,de  Bundesliga,23-052,2002.0,10.4,12,9,5,3,4,4,10,40.0,6,11,1,10,5,17,5,0
30,Simon Adingra,CIV,"FW,MF",Brighton,eng  Premier League,23-069,2002.0,6.9,14,7,7,5,2,6,18,33.3,12,7,0,7,6,20,3,1
31,Amine Adli,MAR,"MF,FW",Leverkusen,de  Bundesliga,24-305,2000.0,4.5,10,6,2,1,7,3,7,42.9,4,6,0,6,0,10,3,0
32,Yacine Adli,FRA,MF,Fiorentina,it  Serie A,24-225,2000.0,12.4,31,18,11,15,5,17,38,44.7,21,11,1,10,6,37,18,0
33,Adrián,ESP,GK,Betis,es  La Liga,38-067,1987.0,8.0,0,0,0,0,0,0,1,0.0,1,0,0,0,0,0,3,0
34,Adryelson,BRA,DF,Lyon,fr  Ligue 1,26-353,1998.0,0.0,0,0,0,0,0,0,0,,0,0,0,0,1,1,1,0
35,Vasilije Adžić,MNE,"MF,FW",Juventus,it  Serie A,18-303,2006.0,0.3,2,2,0,1,1,0,1,0.0,1,0,0,0,0,2,0,0
36,Michel Aebischer,SUI,MF,Bologna,it  Serie A,28-064,1997.0,4.7,10,7,3,5,2,7,11,63.6,4,3,1,2,5,15,5,0
37,Oladapo Afolayan,ENG,"FW,MF",St. Pauli,de  Bundesliga,27-027,1998.0,15.3,16,8,4,8,4,6,18,33.3,12,14,1,13,7,23,17,0
38,Emmanuel Agbadou,CIV,DF,Wolves,eng  Premier League,27-267,1997.0,5.7,14,9,10,4,0,7,11,63.6,4,6,4,2,7,21,34,0
39,Emmanuel Agbadou,CIV,DF,Reims,fr  Ligue 1,27-267,1997.0,14.0,25,17,19,3,3,19,26,73.1,7,22,13,9,19,44,64,1
40,Asher Agbinone,ENG,MF,Crystal Palace,eng  Premier League,19-164,2005.0,0.1,2,1,0,2,0,0,0,,0,0,0,0,0,2,0,0
41,Jeremy Agbonifo,SWE,"FW,MF",Lens,fr  Ligue 1,19-138,2005.0,1.6,3,3,3,0,0,2,2,100.0,0,0,0,0,1,4,0,1
42,Julen Agirrezabala,ESP,GK,Athletic Club,es  La Liga,24-075,2000.0,13.4,0,0,0,0,0,0,1,0.0,1,0,0,0,0,0,4,0
43,Lucien Agoume,FRA,MF,Sevilla,es  La Liga,23-030,2002.0,13.8,35,11,10,21,4,14,21,66.7,7,19,7,12,23,58,18,0
44,Felix Agu,GER,DF,Werder Bremen,de  Bundesliga,25-165,1999.0,11.0,16,8,8,6,2,9,16,56.3,7,10,5,5,12,28,32,0
45,Álvaro Aguado,ESP,MF,Espanyol,es  La Liga,28-314,1996.0,4.5,4,2,2,2,0,2,8,25.0,6,6,1,5,3,7,5,1
46,Lorenzo Aguado,ESP,DF,Real Madrid,es  La Liga,22-173,2002.0,0.1,0,0,0,0,0,0,0,,0,0,0,0,0,0,2,0
47,Nayef Aguerd,MAR,DF,Real Sociedad,es  La Liga,28-346,1996.0,18.6,30,24,17,12,1,12,18,66.7,6,21,15,6,13,43,88,0
48,Ruben Aguilar,FRA,DF,Lens,fr  Ligue 1,31-319,1993.0,6.8,27,14,13,10,4,20,30,66.7,10,15,2,13,8,35,14,0
49,Naouirou Ahamada,FRA,"MF,FW",Rennes,fr  Ligue 1,22-347,2002.0,0.6,0,0,0,0,0,0,0,,0,0,0,0,2,2,2,0
50,Honest Ahanor,ITA,DF,Genoa,it  Serie A,17-016,2008.0,0.9,2,1,0,2,0,2,4,50.0,2,0,0,0,0,2,2,0
51,Erik Ahlstrand,SWE,"FW,MF",St. Pauli,de  Bundesliga,23-148,2001.0,0.5,0,0,0,0,0,0,0,,0,1,0,1,1,1,1,0
52,Jean-Eudes Aholou,CIV,MF,Angers,fr  Ligue 1,30-356,1994.0,19.5,50,32,24,17,9,20,41,48.8,21,30,14,16,33,83,31,0
53,Joseph Aidoo,GHA,DF,Valladolid,es  La Liga,29-163,1995.0,2.7,3,3,2,1,0,2,2,100.0,0,0,0,0,3,6,10,0
54,Joseph Aidoo,GHA,DF,Celta Vigo,es  La Liga,29-163,1995.0,0.0,1,0,1,0,0,0,0,,0,0,0,0,0,1,0,0
55,Ayman Aiki,FRA,"FW,MF",Saint-Étienne,fr  Ligue 1,19-259,2005.0,1.4,3,3,1,2,0,1,1,100.0,0,1,0,1,1,4,0,0
56,Ola Aina,NGA,DF,Nott'ham Forest,eng  Premier League,28-154,1996.0,27.1,53,40,39,13,1,34,57,59.6,23,30,10,20,30,83,86,3
57,Rayan Aït-Nouri,ALG,DF,Wolves,eng  Premier League,23-278,2001.0,25.6,67,39,43,20,4,34,54,63.0,20,35,6,29,19,86,56,1
58,Junior Ajayi,CIV,FW,Hellas Verona,it  Serie A,20-151,2004.0,0.0,0,0,0,0,0,0,0,,0,0,0,0,0,0,0,0
59,Kristoffer Ajer,NOR,DF,Brentford,eng  Premier League,26-328,1998.0,12.6,18,13,10,7,1,9,20,45.0,11,14,3,11,9,27,39,0
60,Ludovic Ajorque,FRA,FW,Brest,fr  Ligue 1,31-014,1994.0,19.5,19,15,3,7,9,6,19,31.6,13,16,4,12,4,23,17,0
61,Manuel Akanji,SUI,DF,Manchester City,eng  Premier League,29-235,1995.0,19.0,15,10,8,4,3,7,12,58.3,5,11,8,3,7,22,55,3
62,Ümit Akdag,ROU,DF,Toulouse,fr  Ligue 1,21-156,2003.0,4.8,5,2,1,4,0,3,9,33.3,6,8,6,2,11,16,15,0
63,Nathan Aké,NED,DF,Manchester City,eng  Premier League,30-021,1995.0,7.5,9,7,7,2,0,4,6,66.7,2,7,2,5,3,12,22,1
64,Ilias Akhomach,MAR,"MF,FW",Villarreal,es  La Liga,20-329,2004.0,6.5,12,7,4,4,4,6,12,50.0,6,8,0,8,3,15,13,0
65,Sergio Akieme,ESP,DF,Reims,fr  Ligue 1,27-085,1997.0,19.5,27,18,24,2,1,17,28,60.7,11,20,6,14,13,40,61,4
66,Maghnes Akliouche,FRA,"FW,MF",Monaco,fr  Ligue 1,23-014,2002.0,18.9,37,21,11,15,11,15,32,46.9,17,16,0,16,11,48,9,0
67,Clément Akpa,CIV,DF,Auxerre,fr  Ligue 1,23-107,2001.0,20.6,48,30,31,11,6,28,39,71.8,11,33,11,22,30,78,103,2
68,Jean-Daniel Akpa-Akpro,CIV,"MF,DF",Monza,it  Serie A,32-151,1992.0,2.5,6,3,5,1,0,3,8,37.5,5,8,2,6,2,8,3,0
69,David Akpan Ankeye,NGA,"FW,MF",Genoa,it  Serie A,23-025,2002.0,0.5,0,0,0,0,0,0,1,0.0,1,0,0,0,0,0,1,0
70,Kevin Akpoguma,NGA,DF,Hoffenheim,de  Bundesliga,29-326,1995.0,18.8,35,18,22,9,4,20,32,62.5,12,56,33,23,22,57,84,1
71,Chuba Akpom,ENG,FW,Lille,fr  Ligue 1,29-153,1995.0,3.2,2,1,0,1,1,1,2,50.0,1,3,0,3,0,2,2,0
72,David Alaba,AUT,DF,Real Madrid,es  La Liga,32-260,1992.0,2.9,1,0,1,0,0,0,0,,0,5,5,0,4,5,5,0
73,Andreas Albers,DEN,FW,St. Pauli,de  Bundesliga,34-353,1990.0,0.7,1,1,0,0,1,0,1,0.0,1,0,0,0,0,1,1,0
74,Raúl Albiol,ESP,DF,Villarreal,es  La Liga,39-188,1985.0,13.2,10,9,9,1,0,6,10,60.0,4,10,9,1,6,16,69,1
75,Carlos Alcaraz,ARG,MF,Southampton,eng  Premier League,22-101,2002.0,0.1,0,0,0,0,0,0,0,,0,0,0,0,1,1,0,0
76,Carlos Alcaraz,ARG,"MF,FW",Everton,eng  Premier League,22-101,2002.0,2.5,5,2,3,1,1,1,3,33.3,2,3,1,2,1,6,3,0
77,Omar Alderete,PAR,DF,Getafe,es  La Liga,28-075,1996.0,23.7,31,20,22,7,2,16,21,76.2,5,28,19,9,29,60,152,1
78,Carles Aleñá,ESP,"MF,FW",Getafe,es  La Liga,27-065,1998.0,5.0,6,3,2,3,1,4,13,30.8,9,9,1,8,0,6,7,0
79,Carles Aleñá,ESP,"MF,FW",Alavés,es  La Liga,27-065,1998.0,4.0,7,4,3,2,2,1,5,20.0,4,3,0,3,0,7,0,0
80,Trent Alexander-Arnold,ENG,DF,Liverpool,eng  Premier League,26-155,1998.0,23.8,67,47,41,17,9,46,99,46.5,53,25,8,17,30,97,51,4
81,Alfon,ESP,"FW,MF",Celta Vigo,es  La Liga,25-311,1999.0,7.6,4,2,1,2,1,2,7,28.6,5,5,0,5,3,7,5,0
82,Mohamed Ali Cho,FRA,"FW,MF",Nice,fr  Ligue 1,21-051,2004.0,15.8,11,7,4,3,4,3,10,30.0,7,14,1,13,3,14,8,0
83,Faride Alidou,GER,"FW,MF",Hellas Verona,it  Serie A,23-236,2001.0,0.8,0,0,0,0,0,0,0,,0,1,0,1,1,1,3,1
84,Alisson,BRA,GK,Liverpool,eng  Premier League,32-160,1992.0,20.9,1,0,1,0,0,0,1,0.0,1,0,0,0,0,1,12,1
85,Tadeo Allende,ARG,FW,Celta Vigo,es  La Liga,26-019,1999.0,0.0,0,0,0,0,0,0,0,,0,0,0,0,0,0,0,0
86,Jim Allevinah,GAB,FW,Angers,fr  Ligue 1,30-012,1995.0,14.8,13,9,5,6,2,3,21,14.3,18,9,0,9,9,22,16,0
87,Thiago Almada,ARG,"MF,FW",Lyon,fr  Ligue 1,23-319,2001.0,3.1,3,1,2,1,0,2,8,25.0,6,1,0,1,1,4,2,0
88,Domingos André Ribeiro Almeida,POR,"MF,FW",Valencia,es  La Liga,24-285,2000.0,14.7,37,22,14,16,7,11,23,47.8,12,14,1,13,6,43,9,1
89,Iker Almena,ESP,"FW,DF",Girona,es  La Liga,20-311,2004.0,0.5,0,0,0,0,0,0,1,0.0,1,1,0,1,0,0,2,0
90,Miguel Almirón,PAR,FW,Newcastle Utd,eng  Premier League,31-029,1994.0,1.7,3,2,2,0,1,2,3,66.7,1,2,0,2,0,3,0,0
91,Pontus Almqvist,SWE,"FW,MF",Parma,it  Serie A,25-244,1999.0,10.3,14,10,7,5,2,8,15,53.3,7,11,0,11,16,30,6,0
92,Marcos Alonso,ESP,DF,Celta Vigo,es  La Liga,34-073,1990.0,20.0,24,17,13,8,3,18,31,58.1,13,17,5,12,26,50,93,4
93,Giorgio Altare,ITA,DF,Venezia,it  Serie A,26-214,1998.0,8.4,13,12,8,3,2,8,15,53.3,7,21,11,10,17,30,49,0
94,Adrià Altimira,ESP,"DF,FW",Leganés,es  La Liga,23-348,2001.0,12.0,30,15,20,8,2,15,26,57.7,11,11,6,5,12,42,41,2
95,Sergi Altimira,ESP,MF,Betis,es  La Liga,23-198,2001.0,16.8,50,29,12,32,6,29,47,61.7,18,24,1,23,16,66,33,1
96,Edson Álvarez,MEX,MF,West Ham,eng  Premier League,27-138,1997.0,17.1,42,21,24,11,7,15,31,48.4,16,21,8,13,16,58,38,1
97,Hugo Álvarez,ESP,"MF,DF",Celta Vigo,es  La Liga,21-252,2003.0,15.4,23,9,11,10,2,9,17,52.9,8,18,1,17,7,30,25,1
98,Julián Álvarez,ARG,"FW,MF",Atlético Madrid,es  La Liga,25-039,2000.0,19.5,19,13,4,6,9,6,23,26.1,17,13,0,13,0,19,9,1
99,Yeray Álvarez,ESP,DF,Athletic Club,es  La Liga,30-046,1995.0,14.8,21,12,11,8,2,11,17,64.7,6,7,4,3,28,49,75,1
100,Skelly Alvero,FRA,MF,Werder Bremen,de  Bundesliga,22-311,2002.0,2.6,11,6,5,5,1,4,5,80.0,1,4,0,4,2,13,10,0
101,Will Alves,ENG,FW,Leicester City,eng  Premier League,20-036,2005.0,0.0,0,0,0,0,0,0,0,,0,0,0,0,0,0,0,0
102,Selim Amallah,MAR,MF,Valladolid,es  La Liga,28-116,1996.0,11.6,21,14,6,14,1,5,12,41.7,7,17,1,16,7,28,3,1
103,Amath,SEN,"FW,DF",Valladolid,es  La Liga,28-238,1996.0,3.5,1,0,1,0,0,1,6,16.7,5,7,1,6,2,3,3,0
104,Jordan Amavi,FRA,DF,Brest,fr  Ligue 1,31-002,1994.0,8.8,24,17,10,11,3,15,21,71.4,6,10,2,8,7,31,18,0
105,Aurele Amenda,SUI,DF,Eint Frankfurt,de  Bundesliga,21-223,2003.0,0.8,0,0,0,0,0,0,0,,0,2,2,0,1,1,4,0
106,Kelvin Amian,FRA,DF,Nantes,fr  Ligue 1,27-031,1998.0,17.4,41,23,33,8,0,19,22,86.4,3,14,8,6,8,49,52,0
107,Michael Amir Murillo,PAN,DF,Marseille,fr  Ligue 1,29-028,1996.0,20.1,38,23,23,9,6,23,36,63.9,13,14,5,9,12,50,51,3
108,Nadiem Amiri,GER,MF,Mainz 05,de  Bundesliga,28-135,1996.0,19.5,29,15,9,16,4,7,32,21.9,25,17,4,13,14,43,22,2
109,Samuel Amo-Ameyaw,ENG,"FW,DF",Southampton,eng  Premier League,18-236,2006.0,0.3,1,0,0,1,0,1,1,100.0,0,0,0,0,0,1,0,0
110,Mathis Amougou,FRA,MF,Chelsea,eng  Premier League,19-052,2006.0,0.1,0,0,0,0,0,0,0,,0,0,0,0,0,0,0,0
111,Mathis Amougou,FRA,MF,Saint-Étienne,fr  Ligue 1,19-052,2006.0,9.5,21,15,15,5,1,10,19,52.6,9,10,0,10,12,33,4,0
112,Mohamed Amoura,ALG,FW,Wolfsburg,de  Bundesliga,24-306,2000.0,21.0,21,15,9,5,7,9,27,33.3,18,31,1,30,9,30,18,0
113,Sofyan Amrabat,MAR,MF,Fiorentina,it  Serie A,28-202,1996.0,2.0,3,2,1,2,0,2,2,100.0,0,1,1,0,0,3,2,0
114,Joachim Andersen,DEN,DF,Crystal Palace,eng  Premier League,28-284,1996.0,1.0,1,1,1,0,0,1,2,50.0,1,0,0,0,0,1,7,0
115,Joachim Andersen,DEN,DF,Fulham,eng  Premier League,28-284,1996.0,18.7,19,15,15,3,1,12,18,66.7,6,16,11,5,25,44,103,0
116,Elliot Anderson,ENG,MF,Nott'ham Forest,eng  Premier League,22-125,2002.0,21.0,66,44,41,19,6,36,75,48.0,39,38,8,30,21,87,49,2
117,André,BRA,MF,Wolves,eng  Premier League,23-238,2001.0,18.4,57,39,25,27,5,24,40,60.0,16,32,7,25,22,79,26,1
118,Benjamin André,FRA,MF,Lille,fr  Ligue 1,34-220,1990.0,21.9,62,30,20,36,6,36,68,52.9,32,32,6,26,36,98,40,0
119,Marcos André,BRA,FW,Valladolid,es  La Liga,28-142,1996.0,12.8,9,6,3,4,2,4,12,33.3,8,17,2,15,3,12,10,0
120,Robert Andrich,GER,MF,Leverkusen,de  Bundesliga,30-170,1994.0,13.8,19,10,6,12,1,5,11,45.5,6,12,6,6,21,40,16,0
121,Angeliño,ESP,DF,Roma,it  Serie A,28-066,1997.0,25.3,35,16,14,19,2,14,25,56.0,11,26,8,18,23,58,65,0
122,Lorenzo Anghelè,ITA,FW,Juventus,it  Serie A,20-013,2005.0,0.1,0,0,0,0,0,0,0,,0,0,0,0,0,0,0,0
123,Faustino Anjorin,ENG,MF,Empoli,it  Serie A,23-108,2001.0,10.9,26,12,7,13,6,8,17,47.1,9,14,3,11,11,37,19,0
124,Waldemar Anton,GER,DF,Dortmund,de  Bundesliga,28-234,1996.0,12.7,21,16,9,8,4,10,15,66.7,5,25,13,12,12,33,50,1
125,Leandro Antonetti,PUR,FW,Sevilla,es  La Liga,22-057,2003.0,0.1,0,0,0,0,0,0,0,,0,0,0,0,0,0,0,0
126,Michail Antonio,JAM,FW,West Ham,eng  Premier League,34-348,1990.0,9.3,2,2,0,1,1,2,3,66.7,1,6,0,6,0,2,2,0
127,Antoniu,ESP,"MF,FW",Espanyol,es  La Liga,22-187,2002.0,5.4,10,4,3,3,4,5,12,41.7,7,8,1,7,3,13,4,1
128,Antony,BRA,"DF,MF",Manchester Utd,eng  Premier League,25-015,2000.0,1.6,6,3,4,2,0,2,5,40.0,3,2,0,2,2,8,0,0
129,Antony,BRA,FW,Betis,es  La Liga,25-015,2000.0,5.6,13,6,3,5,5,2,10,20.0,8,7,0,7,5,18,6,1
130,Anuar,MAR,"FW,MF",Valladolid,es  La Liga,30-055,1995.0,13.5,24,16,15,4,5,7,19,36.8,12,19,6,13,12,36,12,1
131,Dennis Appiah,FRA,DF,Saint-Étienne,fr  Ligue 1,32-275,1992.0,17.6,50,34,29,18,3,31,55,56.4,24,24,6,18,18,68,69,1
132,Aritz Arambarri,ESP,DF,Leganés,es  La Liga,27-039,1998.0,2.0,1,1,1,0,0,1,1,100.0,0,2,2,0,3,4,8,0
133,Mauro Arambarri,URU,MF,Getafe,es  La Liga,29-162,1995.0,20.1,30,14,5,21,4,12,29,41.4,17,23,5,18,9,39,33,0
134,Jon Aramburu,VEN,DF,Real Sociedad,es  La Liga,22-231,2002.0,20.3,77,57,44,24,9,52,77,67.5,25,27,6,21,26,103,75,0
135,Julian Araujo,MEX,DF,Bournemouth,eng  Premier League,23-210,2001.0,3.9,7,3,3,4,0,4,10,40.0,6,3,0,3,4,11,13,0
136,Ronald Araújo,URU,DF,Barcelona,es  La Liga,26-004,1999.0,2.6,4,3,1,3,0,1,1,100.0,0,0,0,0,2,6,6,0
137,Cameron Archer,ENG,FW,Southampton,eng  Premier League,23-233,2001.0,12.9,10,6,5,3,2,1,6,16.7,5,5,1,4,2,12,6,0
138,Carlens Arcus,HAI,DF,Angers,fr  Ligue 1,28-256,1996.0,17.1,37,23,23,12,2,24,40,60.0,16,16,3,13,24,61,62,2
139,Alphonse Areola,FRA,GK,West Ham,eng  Premier League,32-012,1993.0,16.1,2,2,2,0,0,2,3,66.7,1,0,0,0,0,2,8,1
140,Adu Ares,ESP,FW,Athletic Club,es  La Liga,23-150,2001.0,0.2,0,0,0,0,0,0,1,0.0,1,0,0,0,0,0,0,0
141,Jesús Areso,ESP,DF,Osasuna,es  La Liga,25-252,1999.0,22.6,35,25,24,7,4,26,39,66.7,13,20,3,17,7,42,62,0
142,David Argüelles,ESP,MF,Getafe,es  La Liga,23-069,2002.0,0.1,0,0,0,0,0,0,0,,0,2,0,2,0,0,0,0
143,Joe Aribo,NGA,"MF,DF",Southampton,eng  Premier League,28-233,1996.0,19.3,42,28,14,22,6,16,32,50.0,16,23,9,14,18,60,28,3
144,Adam Armstrong,ENG,"FW,MF",Southampton,eng  Premier League,28-029,1997.0,13.9,12,3,2,7,3,3,14,21.4,11,6,1,5,3,15,8,0
145,Harrison Armstrong,ENG,MF,Everton,eng  Premier League,18-051,2007.0,0.5,0,0,0,0,0,0,1,0.0,1,0,0,0,0,0,1,0
146,José Arnaiz,ESP,"FW,MF",Osasuna,es  La Liga,29-330,1995.0,0.6,3,3,1,1,1,1,2,50.0,1,0,0,0,1,4,1,0
147,Hákon Arnar Haraldsson,ISL,"MF,FW",Lille,fr  Ligue 1,21-335,2003.0,12.6,21,9,6,11,4,8,21,38.1,13,6,1,5,6,27,4,0
148,Marko Arnautović,AUT,FW,Inter,it  Serie A,35-326,1989.0,2.7,6,5,1,2,3,3,4,75.0,1,0,0,0,1,7,1,0
149,Maximilian Arnold,GER,MF,Wolfsburg,de  Bundesliga,30-288,1994.0,19.9,25,15,9,14,2,11,23,47.8,12,17,9,8,13,38,54,1
150,Jann-Fiete Arp,GER,"FW,MF",Holstein Kiel,de  Bundesliga,25-064,2000.0,7.1,12,9,5,2,5,4,13,30.8,9,5,0,5,2,14,7,0
151,Sergio Arribas,ESP,DF,Betis,es  La Liga,22-029,2003.0,1.0,7,4,4,3,0,6,7,85.7,1,2,2,0,3,10,4,0
152,Kepa Arrizabalaga,ESP,GK,Bournemouth,eng  Premier League,30-159,1994.0,21.0,1,0,1,0,0,0,1,0.0,1,1,0,1,0,1,10,3
153,Arthur,BRA,"DF,FW",Leverkusen,de  Bundesliga,21-359,2003.0,5.5,13,10,3,8,2,5,10,50.0,5,7,0,7,8,21,18,0
154,Takuma Asano,JPN,"FW,MF",Mallorca,es  La Liga,30-121,1994.0,8.3,9,6,3,5,1,4,8,50.0,4,6,0,6,5,14,6,0
155,Raúl Asencio,ESP,DF,Real Madrid,es  La Liga,22-026,2003.0,10.5,14,8,12,2,0,7,9,77.8,2,4,3,1,6,20,49,2
156,Marco Asensio,ESP,"MF,FW",Aston Villa,eng  Premier League,29-049,1996.0,2.3,2,1,0,2,0,2,5,40.0,3,1,0,1,1,3,1,0
157,Marco Asensio,ESP,"FW,MF",Paris S-G,fr  Ligue 1,29-049,1996.0,6.9,4,3,1,3,0,0,6,0.0,6,1,0,1,0,4,1,0
158,Kristjan Asllani,ALB,MF,Inter,it  Serie A,23-002,2002.0,6.7,9,1,4,4,1,3,14,21.4,11,6,1,5,5,14,9,1
159,Iago Aspas,ESP,"FW,MF",Celta Vigo,es  La Liga,37-222,1987.0,14.7,12,8,4,5,3,8,17,47.1,9,16,1,15,6,18,4,0
160,Yaser Asprilla,COL,"FW,MF",Girona,es  La Liga,21-112,2003.0,9.7,14,8,5,6,3,5,11,45.5,6,6,0,6,3,17,4,1
161,Lorenz Assignon,TOG,"DF,MF",Rennes,fr  Ligue 1,24-262,2000.0,18.2,30,17,16,13,1,10,29,34.5,19,15,3,12,19,49,52,0
162,Dehmaine Assoumani,FRA,"MF,FW",Nantes,fr  Ligue 1,19-328,2005.0,0.9,6,3,0,4,2,4,5,80.0,1,1,0,1,1,7,3,0
163,Valentin Atangana Edoa,FRA,MF,Reims,fr  Ligue 1,19-198,2005.0,22.7,52,39,25,22,5,20,28,71.4,8,22,11,11,30,82,37,0
164,Arthur Atta,FRA,"MF,FW",Udinese,it  Serie A,22-056,2003.0,5.7,12,6,5,6,1,9,12,75.0,3,4,3,1,1,13,5,1
165,Noah Atubolu,GER,GK,Freiburg,de  Bundesliga,22-290,2002.0,22.0,0,0,0,0,0,0,0,,0,0,0,0,0,0,12,3
166,Emil Audero,ITA,GK,Como,it  Serie A,28-052,1997.0,8.0,0,0,0,0,0,0,1,0.0,1,0,0,0,0,0,4,1
167,Tommaso Augello,ITA,"DF,FW",Cagliari,it  Serie A,30-193,1994.0,21.2,36,19,20,12,4,22,31,71.0,9,17,4,13,15,51,72,0
168,Carlos Augusto,BRA,"DF,FW",Inter,it  Serie A,26-063,1999.0,10.5,20,10,8,8,4,9,13,69.2,4,10,4,6,4,24,24,0
169,Yann Aurel Bisseck,GER,DF,Inter,it  Serie A,24-102,2000.0,11.9,13,10,7,4,2,9,11,81.8,2,14,7,7,11,24,42,1
170,Brandon Austin,ENG,GK,Tottenham,eng  Premier League,26-062,1999.0,1.0,0,0,0,0,0,0,0,,0,0,0,0,0,0,1,0
171,Ezequiel Ávila,ARG,FW,Betis,es  La Liga,31-033,1994.0,7.0,7,3,1,2,4,3,8,37.5,5,4,0,4,2,9,6,0
172,Taiwo Awoniyi,NGA,FW,Nott'ham Forest,eng  Premier League,27-211,1997.0,3.0,4,2,0,3,1,2,3,66.7,1,1,0,1,0,4,4,0
173,Yasin Ayari,SWE,MF,Brighton,eng  Premier League,21-156,2003.0,15.9,43,22,11,24,8,18,41,43.9,23,17,5,12,16,59,18,0
174,Florian Ayé,FRA,FW,Auxerre,fr  Ligue 1,28-051,1997.0,4.5,2,2,0,0,2,0,1,0.0,1,5,0,5,4,6,6,0
175,André Ayew,GHA,FW,Le Havre,fr  Ligue 1,35-084,1989.0,11.1,11,8,2,4,5,6,10,60.0,4,8,2,6,2,13,14,0
176,Jordan Ayew,GHA,"FW,MF",Crystal Palace,eng  Premier League,33-181,1991.0,0.2,1,0,0,0,1,0,0,,0,0,0,0,0,1,0,0
177,Jordan Ayew,GHA,"FW,MF",Leicester City,eng  Premier League,33-181,1991.0,14.4,22,12,7,12,3,5,17,29.4,12,14,0,14,12,34,16,0
178,Neil El Aynaoui,FRA,MF,Lens,fr  Ligue 1,23-252,2001.0,10.1,23,12,12,7,4,6,24,25.0,18,21,3,18,11,34,15,0
179,Ayman Azhil,MAR,MF,Dortmund,de  Bundesliga,23-335,2001.0,0.3,1,1,1,0,0,0,0,,0,0,0,0,0,1,0,0
180,Adam Aznou,MAR,"DF,MF",Valladolid,es  La Liga,18-282,2006.0,2.6,10,9,8,2,0,8,14,57.1,6,7,1,6,4,14,5,0
181,Adam Aznou,MAR,DF,Bayern Munich,de  Bundesliga,18-282,2006.0,0.2,0,0,0,0,0,0,0,,0,0,0,0,0,0,1,0
182,César Azpilicueta,ESP,DF,Atlético Madrid,es  La Liga,35-195,1989.0,6.3,14,6,8,4,2,11,17,64.7,6,3,1,2,2,16,19,0
183,Paulo Azzi,BRA,DF,Cagliari,it  Serie A,30-239,1994.0,4.7,11,9,3,6,2,5,9,55.6,4,5,2,3,5,16,11,0
184,Oussama El Azzouzi,MAR,MF,Bologna,it  Serie A,23-286,2001.0,0.1,0,0,0,0,0,0,0,,0,0,0,0,2,2,0,0
185,Papa Ba,ESP,MF,Girona,es  La Liga,20-180,2004.0,0.5,1,1,1,0,0,0,0,,0,1,0,1,0,1,1,0
186,Shavy Babicka,GAB,"MF,FW",Toulouse,fr  Ligue 1,24-283,2000.0,10.8,21,12,6,11,4,10,21,47.6,11,13,0,13,2,23,4,2
187,Jacopo Bacci,ITA,MF,Empoli,it  Serie A,19-265,2005.0,0.1,1,0,1,0,0,1,1,100.0,0,0,0,0,1,2,0,0
188,Aliou Badara Baldé,GUI,"MF,FW",Bochum,de  Bundesliga,22-089,2002.0,1.0,1,1,1,0,0,0,0,,0,2,0,2,0,1,0,0
189,Loïc Bade,FRA,DF,Sevilla,es  La Liga,24-334,2000.0,21.2,39,23,30,9,0,19,26,73.1,7,17,9,8,22,61,105,2
190,Milan Badelj,CRO,MF,Genoa,it  Serie A,36-014,1989.0,14.9,25,12,14,6,5,13,33,39.4,20,18,6,12,18,43,41,0
191,Benoît Badiashile,FRA,DF,Chelsea,eng  Premier League,23-350,2001.0,2.8,6,4,3,3,0,2,2,100.0,0,2,2,0,6,12,6,1
192,Alex Baena,ESP,"MF,FW",Villarreal,es  La Liga,23-234,2001.0,22.2,22,11,6,11,5,8,32,25.0,24,28,2,26,18,40,15,2
193,Juma Bah,SLE,DF,Valladolid,es  La Liga,18-334,2006.0,9.6,10,7,7,3,0,3,5,60.0,2,15,8,7,12,22,60,0
194,Juma Bah,SLE,DF,Lens,fr  Ligue 1,18-334,2006.0,1.2,3,2,0,3,0,1,3,33.3,2,2,2,0,2,5,12,0
195,Leon Bailey,JAM,"FW,MF",Aston Villa,eng  Premier League,27-214,1997.0,12.6,6,4,1,3,2,2,10,20.0,8,6,0,6,3,9,12,0
196,Eric Bailly,CIV,DF,Villarreal,es  La Liga,30-333,1994.0,6.4,11,3,5,6,0,2,3,66.7,1,11,6,5,6,17,26,0
197,Theo Bair,CAN,FW,Auxerre,fr  Ligue 1,25-196,1999.0,8.0,4,3,1,2,1,0,2,0.0,2,6,2,4,3,7,7,0
198,Stefan Bajcetic,ESP,"MF,DF",Las Palmas,es  La Liga,20-140,2004.0,4.5,11,6,6,3,2,4,15,26.7,11,14,1,13,8,19,16,1
199,Cédric Bakambu,COD,FW,Betis,es  La Liga,33-334,1991.0,5.9,3,2,0,3,0,1,5,20.0,4,7,1,6,0,3,4,0
200,Mitchel Bakker,NED,MF,Atalanta,it  Serie A,24-264,2000.0,0.2,1,0,1,0,0,1,1,100.0,0,0,0,0,0,1,0,0
201,Mitchel Bakker,NED,"DF,FW",Lille,fr  Ligue 1,24-264,2000.0,8.5,21,13,6,10,5,9,16,56.3,7,8,1,7,10,31,13,0
202,Darryl Bakola,FRA,DF,Marseille,fr  Ligue 1,17-101,2007.0,0.1,1,1,0,1,0,0,0,,0,0,0,0,0,1,0,0
203,Ridle Baku,GER,"FW,MF",Wolfsburg,de  Bundesliga,26-337,1998.0,13.0,23,15,9,9,5,8,19,42.1,11,22,1,21,15,38,15,0
204,Ridle Baku,GER,"DF,MF",RB Leipzig,de  Bundesliga,26-337,1998.0,7.9,13,10,5,8,0,4,11,36.4,7,11,2,9,2,15,33,0
205,Dilane Bakwa,FRA,"MF,DF",Strasbourg,fr  Ligue 1,22-197,2002.0,20.3,20,11,10,5,5,8,18,44.4,10,15,0,15,9,29,24,0
206,Tommaso Baldanzi,ITA,"MF,FW",Roma,it  Serie A,21-353,2003.0,6.7,12,4,5,4,3,4,9,44.4,5,3,0,3,4,16,6,0
207,Alejandro Balde,ESP,DF,Barcelona,es  La Liga,21-144,2003.0,19.9,12,7,8,3,1,7,11,63.6,4,17,4,13,5,17,22,0
208,Keita Baldé,SEN,"FW,MF",Monza,it  Serie A,30-003,1995.0,2.1,1,1,0,1,0,1,2,50.0,1,0,0,0,1,2,0,0
209,Carlos Baleba,CMR,MF,Brighton,eng  Premier League,21-067,2004.0,20.7,57,30,17,29,11,35,55,63.6,20,32,5,27,37,94,24,1
210,Leonardo Balerdi,ARG,DF,Marseille,fr  Ligue 1,26-044,1999.0,20.0,39,27,22,13,4,18,34,52.9,16,24,14,10,30,69,55,4
211,Iván Balliu,ALB,DF,Rayo Vallecano,es  La Liga,33-069,1992.0,8.7,10,8,2,5,3,3,11,27.3,8,9,2,7,7,17,22,0
212,Fodé Ballo-Touré,SEN,DF,Le Havre,fr  Ligue 1,28-067,1997.0,2.3,2,2,0,2,0,2,4,50.0,2,2,0,2,1,3,10,0
213,Botond Balogh,HUN,DF,Parma,it  Serie A,22-278,2002.0,19.8,26,9,17,9,0,15,21,71.4,6,31,24,7,22,48,128,2
214,Folarin Balogun,USA,FW,Monaco,fr  Ligue 1,23-251,2001.0,5.2,0,0,0,0,0,0,2,0.0,2,0,0,0,0,0,0,0
215,Mario Balotelli,ITA,"FW,MF",Genoa,it  Serie A,34-211,1990.0,0.7,0,0,0,0,0,0,0,,0,0,0,0,0,0,1,0
216,Abdoulaye Bamba,CIV,DF,Angers,fr  Ligue 1,34-320,1990.0,10.8,15,7,11,3,1,9,12,75.0,3,9,5,4,12,27,52,0
217,Jonathan Bamba,CIV,"FW,MF",Celta Vigo,es  La Liga,28-350,1996.0,9.0,12,7,4,6,2,5,12,41.7,7,6,0,6,5,17,6,0
218,Mohamed Bamba,CIV,MF,Reims,fr  Ligue 1,20-154,2004.0,0.1,0,0,0,0,0,0,1,0.0,1,2,1,1,0,0,1,0
219,Samuel Bamba,GER,"FW,DF",Bochum,de  Bundesliga,21-026,2004.0,0.2,0,0,0,0,0,0,0,,0,0,0,0,0,0,0,0
220,Lameck Banda,ZAM,"FW,MF",Lecce,it  Serie A,24-041,2001.0,5.7,5,4,4,1,0,3,11,27.3,8,6,0,6,2,7,6,0
221,Daniel Bandeira,POR,MF,Hellas Verona,it  Serie A,24-334,2000.0,4.5,4,0,1,3,0,3,6,50.0,3,2,1,1,6,10,8,0
222,Mattia Bani,ITA,DF,Genoa,it  Serie A,31-091,1993.0,14.8,18,9,11,5,2,7,11,63.6,4,9,5,4,19,37,77,2
223,Noahkai Banks,USA,DF,Augsburg,de  Bundesliga,18-100,2006.0,3.0,11,5,6,4,1,3,7,42.9,4,4,1,3,5,16,27,0
224,Scott Banks,SCO,"FW,MF",St. Pauli,de  Bundesliga,23-166,2001.0,1.1,1,1,1,0,0,0,2,0.0,2,0,0,0,2,3,2,0
225,Adrian Baquerin,ESP,FW,Valladolid,es  La Liga,18-007,2007.0,0.0,0,0,0,0,0,0,0,,0,0,0,0,0,0,0,0
226,Antonín Barák,CZE,MF,Fiorentina,it  Serie A,30-098,1994.0,0.6,2,0,0,2,0,0,2,0.0,2,1,1,0,0,2,0,0
227,Federico Barba,ITA,DF,Como,it  Serie A,31-191,1993.0,4.8,2,2,1,1,0,1,4,25.0,3,2,2,0,4,6,15,0
228,Valentín Barco,ARG,"DF,FW",Sevilla,es  La Liga,20-231,2004.0,3.2,15,9,8,3,4,12,15,80.0,3,0,0,0,2,17,5,0
229,Valentín Barco,ARG,"DF,MF",Strasbourg,fr  Ligue 1,20-231,2004.0,4.3,10,5,9,1,0,7,10,70.0,3,2,0,2,3,13,12,1
230,Bradley Barcola,FRA,FW,Paris S-G,fr  Ligue 1,22-190,2002.0,18.7,22,13,8,6,8,6,26,23.1,20,21,2,19,11,33,9,0
231,Melvin Bard,FRA,"DF,MF",Nice,fr  Ligue 1,24-125,2000.0,14.6,41,27,26,11,4,17,29,58.6,12,22,7,15,18,59,39,2
232,Nicolò Barella,ITA,MF,Inter,it  Serie A,28-032,1997.0,21.4,36,21,12,15,9,17,44,38.6,27,18,2,16,10,46,11,1
233,Gabriel Bares,SUI,"MF,DF",Montpellier,fr  Ligue 1,24-194,2000.0,0.6,2,2,2,0,0,1,2,50.0,1,0,0,0,1,3,3,0
234,Borna Barišić,CRO,DF,Leganés,es  La Liga,32-121,1992.0,0.1,0,0,0,0,0,0,0,,0,0,0,0,0,0,0,0
235,Kike Barja,ESP,"FW,MF",Osasuna,es  La Liga,27-344,1997.0,2.7,3,3,1,2,0,0,1,0.0,1,5,0,5,3,6,4,0
236,Ross Barkley,ENG,MF,Aston Villa,eng  Premier League,31-096,1993.0,6.2,13,3,4,9,0,9,13,69.2,4,9,3,6,9,22,5,0
237,Aymen Barkok,MAR,MF,Mainz 05,de  Bundesliga,26-294,1998.0,0.8,2,1,1,1,0,1,1,100.0,0,1,1,0,2,4,0,0
238,Harvey Barnes,ENG,FW,Newcastle Utd,eng  Premier League,27-092,1997.0,10.0,10,6,3,4,3,3,5,60.0,2,5,1,4,5,15,6,1
239,Enzo Barrenechea,ARG,MF,Valencia,es  La Liga,23-293,2001.0,15.5,39,23,17,16,6,22,31,71.0,9,21,6,15,17,56,30,1
240,Ander Barrenetxea,ESP,"MF,FW",Real Sociedad,es  La Liga,23-074,2001.0,10.1,17,13,5,8,4,4,15,26.7,11,12,0,12,9,26,14,0
241,Pablo Barrios,ESP,MF,Atlético Madrid,es  La Liga,21-269,2003.0,17.8,32,19,14,16,2,14,28,50.0,14,10,3,7,23,55,25,4
242,Thierno Barry,FRA,FW,Villarreal,es  La Liga,22-141,2002.0,17.5,10,7,2,5,3,4,9,44.4,5,14,2,12,0,10,11,0
243,Davide Bartesaghi,ITA,DF,Milan,it  Serie A,19-072,2005.0,0.6,2,1,1,1,0,2,2,100.0,0,1,1,0,1,3,0,0
244,Marc Bartra,ESP,DF,Betis,es  La Liga,34-055,1991.0,14.3,18,13,14,4,0,9,13,69.2,4,20,12,8,24,42,99,0
245,Federico Baschirotto,ITA,DF,Lecce,it  Serie A,28-172,1996.0,28.0,27,18,20,5,2,14,20,70.0,6,37,27,10,19,46,157,1
246,Daniele Baselli,ITA,MF,Como,it  Serie A,32-364,1992.0,0.2,0,0,0,0,0,0,0,,0,0,0,0,1,1,1,0
247,Calvin Bassey,NGA,DF,Fulham,eng  Premier League,25-070,1999.0,26.2,39,24,23,16,0,17,24,70.8,7,33,16,17,15,54,81,5
248,Aboubacar Bassinga,CIV,MF,Las Palmas,es  La Liga,19-241,2005.0,0.0,0,0,0,0,0,0,0,,0,0,0,0,0,0,0,0
249,Alessandro Bastoni,ITA,DF,Inter,it  Serie A,25-332,1999.0,22.4,35,17,16,14,5,16,24,66.7,8,19,9,10,21,56,46,1
250,Augusto Batalla,ARG,GK,Rayo Vallecano,es  La Liga,28-315,1996.0,22.0,3,1,3,0,0,3,4,75.0,1,0,0,0,0,3,6,3
251,Michy Batshuayi,BEL,"FW,DF",Eint Frankfurt,de  Bundesliga,31-160,1993.0,1.7,0,0,0,0,0,0,0,,0,2,0,2,1,1,0,0
252,Dylan Batubinsika,COD,DF,Saint-Étienne,fr  Ligue 1,29-024,1996.0,20.9,23,13,17,5,1,11,19,57.9,8,22,13,9,35,58,132,3
253,Maximilian Bauer,GER,DF,Augsburg,de  Bundesliga,25-030,2000.0,7.3,14,8,5,7,2,9,14,64.3,5,10,4,6,6,20,35,1
254,Oliver Baumann,GER,GK,Hoffenheim,de  Bundesliga,34-282,1990.0,20.0,1,1,1,0,0,1,2,50.0,1,0,0,0,0,1,10,0
255,Christoph Baumgartner,AUT,MF,RB Leipzig,de  Bundesliga,25-222,1999.0,12.9,29,17,6,16,7,10,30,33.3,20,28,7,21,11,40,17,1
256,Rafael Bauza,ESP,MF,Espanyol,es  La Liga,20-040,2005.0,2.0,5,3,3,1,1,4,7,57.1,3,3,1,2,0,5,5,0
257,Adrian Beck,GER,"MF,FW",Heidenheim,de  Bundesliga,27-275,1997.0,9.6,21,9,11,9,1,7,22,31.8,15,24,2,22,6,27,14,0
258,Sheraldo Becker,SUR,"FW,MF",Real Sociedad,es  La Liga,30-030,1995.0,10.8,2,2,0,2,0,0,2,0.0,2,4,0,4,1,3,10,0
259,Timo Becker,GER,DF,Holstein Kiel,de  Bundesliga,27-351,1997.0,19.1,31,20,20,8,3,21,29,72.4,8,24,14,10,12,43,73,0
260,Jan Bednarek,POL,DF,Southampton,eng  Premier League,28-333,1996.0,21.1,29,15,18,11,0,13,26,50.0,13,36,27,9,49,78,132,4
261,Donny van de Beek,NED,MF,Girona,es  La Liga,27-327,1997.0,14.0,27,16,16,7,4,13,25,52.0,12,17,3,14,9,36,10,0
262,Hannes Behrens,GER,DF,Hoffenheim,de  Bundesliga,,,0.3,1,1,0,1,0,0,0,,0,1,0,1,2,3,0,0
263,Kevin Behrens,GER,FW,Wolfsburg,de  Bundesliga,34-036,1991.0,1.5,1,1,0,1,0,0,1,0.0,1,0,0,0,1,2,2,0
264,Maximilian Beier,GER,"FW,MF",Dortmund,de  Bundesliga,22-145,2002.0,13.7,25,16,8,11,6,12,29,41.4,17,13,1,12,5,30,12,1
265,Luken Beitia,ESP,DF,Real Sociedad,es  La Liga,20-254,2004.0,0.1,1,1,1,0,0,1,1,100.0,0,0,0,0,0,1,2,0
266,Ismael Bekhoucha,MAR,MF,Getafe,es  La Liga,20-111,2004.0,0.0,0,0,0,0,0,0,0,,0,0,0,0,2,2,0,0
267,Reda Belahyane,MAR,MF,Hellas Verona,it  Serie A,20-283,2004.0,18.4,36,26,16,13,7,13,17,76.5,4,20,9,11,10,46,22,1
268,Reda Belahyane,MAR,MF,Lazio,it  Serie A,20-283,2004.0,0.9,0,0,0,0,0,0,0,,0,1,1,0,0,0,0,0
269,Haris Belkebla,ALG,MF,Angers,fr  Ligue 1,31-042,1994.0,18.6,51,35,35,13,3,23,42,54.8,19,28,8,20,30,81,42,1
270,Yassin Belkhdim,FRA,"MF,FW",Angers,fr  Ligue 1,23-025,2002.0,9.5,34,18,15,13,6,16,37,43.2,21,16,4,12,13,47,22,1
271,Stefan Bell,GER,DF,Mainz 05,de  Bundesliga,33-199,1991.0,13.1,18,10,14,4,0,8,13,61.5,5,14,12,2,24,42,89,0
272,Armel Bella Kotchap,GER,DF,Southampton,eng  Premier League,23-090,2001.0,2.7,4,3,4,0,0,2,5,40.0,3,2,2,0,4,8,17,1
273,Raoul Bellanova,ITA,DF,Torino,it  Serie A,24-298,2000.0,1.0,0,0,0,0,0,0,1,0.0,1,0,0,0,0,0,4,0
274,Raoul Bellanova,ITA,DF,Atalanta,it  Serie A,24-298,2000.0,18.6,18,11,5,11,2,10,18,55.6,8,11,3,8,15,33,29,0
275,Jean-Ricner Bellegarde,FRA,"MF,FW",Wolves,eng  Premier League,26-257,1998.0,13.5,23,12,7,13,3,9,13,69.2,4,15,3,12,10,33,10,1
276,Héctor Bellerín,ESP,DF,Betis,es  La Liga,29-357,1995.0,5.8,12,7,6,4,2,9,16,56.3,7,4,3,1,6,18,18,0
277,Jude Bellingham,ENG,MF,Real Madrid,es  La Liga,21-255,2003.0,19.0,43,25,15,20,8,17,27,63.0,10,25,2,23,18,61,15,0
278,Jeanuël Belocian,FRA,"DF,MF",Leverkusen,de  Bundesliga,20-022,2005.0,0.8,1,1,1,0,0,1,1,100.0,0,0,0,0,0,1,2,0
279,Andrea Belotti,ITA,FW,Como,it  Serie A,31-081,1993.0,6.6,7,5,1,4,2,1,4,25.0,3,4,0,4,1,8,8,0
280,Fran Beltrán,ESP,MF,Celta Vigo,es  La Liga,26-036,1999.0,18.1,31,22,17,10,4,14,36,38.9,22,22,5,17,17,48,26,3
281,Lucas Beltrán,ARG,"MF,FW",Fiorentina,it  Serie A,23-347,2001.0,16.9,18,8,7,6,5,6,17,35.3,11,13,2,11,4,22,11,0
282,Eliesse Ben Seghir,MAR,"MF,FW",Monaco,fr  Ligue 1,20-023,2005.0,16.3,23,19,7,11,5,13,23,56.5,10,14,0,14,9,32,2,0
283,Carlos Benavídez,URU,MF,Alavés,es  La Liga,26-346,1998.0,3.7,7,5,3,3,1,1,4,25.0,3,3,1,2,8,15,7,1
284,Adrian Benedyczak,POL,"FW,MF",Parma,it  Serie A,24-107,2000.0,2.2,0,0,0,0,0,0,1,0.0,1,3,1,2,0,0,8,0
285,László Bénes,SVK,"MF,FW",Union Berlin,de  Bundesliga,27-183,1997.0,5.2,1,1,0,1,0,0,1,0.0,1,5,1,4,2,3,6,0
286,Iker Benito,ESP,"FW,MF",Osasuna,es  La Liga,22-213,2002.0,0.4,0,0,0,0,0,0,1,0.0,1,0,0,0,1,1,2,0
287,Ismaël Bennacer,ALG,MF,Milan,it  Serie A,27-100,1997.0,3.3,5,4,1,3,1,1,7,14.3,6,5,3,2,3,8,1,0
288,Ismaël Bennacer,ALG,MF,Marseille,fr  Ligue 1,27-100,1997.0,3.6,17,8,5,11,1,11,13,84.6,2,2,0,2,6,23,1,0
289,Saïd Benrahma,ALG,"FW,MF",Lyon,fr  Ligue 1,29-213,1995.0,8.2,9,5,4,4,1,3,10,30.0,7,6,0,6,3,12,2,0
290,Ramy Bensebaini,ALG,DF,Dortmund,de  Bundesliga,29-329,1995.0,16.0,37,16,20,12,5,24,39,61.5,15,32,4,28,17,54,56,1
291,Nabil Bentaleb,ALG,"MF,FW",Lille,fr  Ligue 1,30-107,1994.0,1.5,3,2,1,0,2,2,4,50.0,2,0,0,0,2,5,3,1
292,Rodrigo Bentancur,URU,MF,Tottenham,eng  Premier League,27-259,1997.0,12.9,31,15,13,16,2,16,29,55.2,13,19,6,13,27,58,25,1
293,Lucas Beraldo,BRA,DF,Paris S-G,fr  Ligue 1,21-107,2003.0,16.1,28,23,23,5,0,17,29,58.6,12,9,5,4,18,46,39,2
294,Yuri Berchiche,ESP,DF,Athletic Club,es  La Liga,35-029,1990.0,16.3,22,12,12,8,2,13,23,56.5,10,17,2,15,17,39,39,2
295,Álex Berenguer,ESP,"FW,MF",Athletic Club,es  La Liga,29-250,1995.0,17.6,20,9,2,11,7,11,18,61.1,7,15,2,13,8,28,13,0
296,Sander Berge,NOR,MF,Fulham,eng  Premier League,27-025,1998.0,17.3,40,23,17,20,3,19,28,67.9,9,22,7,15,18,58,28,0
297,Lucas Bergvall,SWE,MF,Tottenham,eng  Premier League,19-037,2006.0,9.9,31,16,11,16,4,14,25,56.0,11,15,7,8,16,47,18,2
298,Medon Berisha,ALB,MF,Lecce,it  Serie A,21-141,2003.0,4.6,5,3,3,1,1,1,4,25.0,3,2,0,2,5,10,4,0
299,Mergim Berisha,GER,"FW,MF",Hoffenheim,de  Bundesliga,26-304,1998.0,3.7,3,3,1,2,0,0,3,0.0,3,2,1,1,0,3,3,0
300,Adrian Bernabe,ESP,MF,Parma,it  Serie A,23-289,2001.0,11.8,27,17,16,7,4,14,28,50.0,14,19,9,10,6,33,20,1
301,Marc Bernal,ESP,MF,Barcelona,es  La Liga,17-289,2007.0,2.7,8,6,2,5,1,7,8,87.5,1,5,1,4,1,9,4,0
302,Bernardo,BRA,DF,Bochum,de  Bundesliga,29-301,1995.0,13.8,39,22,29,9,1,23,30,76.7,7,27,12,15,17,56,67,1
303,Juan Bernat,ESP,"DF,MF",Villarreal,es  La Liga,32-010,1993.0,2.4,9,7,7,1,1,4,5,80.0,1,3,1,2,1,10,4,0
304,Juan Bernat,ESP,MF,Getafe,es  La Liga,32-010,1993.0,3.3,6,4,3,2,1,2,5,40.0,3,2,1,1,1,7,6,0
305,Maxime Bernauer,FRA,DF,Saint-Étienne,fr  Ligue 1,26-253,1998.0,1.5,0,0,0,0,0,0,0,,0,0,0,0,2,2,9,0
306,Antoine Bernede,FRA,"MF,FW",Hellas Verona,it  Serie A,25-289,1999.0,1.9,1,1,0,1,0,1,2,50.0,1,3,1,2,3,4,1,0
307,Alexander Bernhardsson,SWE,"MF,DF",Holstein Kiel,de  Bundesliga,26-184,1998.0,6.4,15,9,5,4,6,10,13,76.9,3,7,0,7,0,15,12,0
308,Victor Bernth Kristiansen,DEN,DF,Leicester City,eng  Premier League,22-085,2002.0,24.4,79,45,52,23,4,42,77,54.5,35,32,13,19,37,116,70,3
309,Matúš Bero,SVK,MF,Bochum,de  Bundesliga,29-186,1995.0,21.2,48,23,21,18,9,23,49,46.9,26,30,5,25,14,62,27,1
310,Juan Berrocal,ESP,DF,Getafe,es  La Liga,25-311,1999.0,8.8,14,7,10,4,0,10,13,76.9,3,2,2,0,10,24,40,0
311,Dimitry Bertaud,COD,GK,Montpellier,fr  Ligue 1,26-278,1998.0,3.0,0,0,0,0,0,0,0,,0,0,0,0,0,0,2,0
312,Jan-Niklas Beste,GER,"FW,MF",Freiburg,de  Bundesliga,26-066,1999.0,1.0,0,0,0,0,0,0,3,0.0,3,0,0,0,1,1,2,0
313,Beto,GNB,FW,Everton,eng  Premier League,27-039,1998.0,9.5,11,5,2,5,4,4,6,66.7,2,4,1,3,1,12,12,0
314,Sam Beukema,NED,DF,Bologna,it  Serie A,26-114,1998.0,25.5,40,22,18,19,3,17,34,50.0,17,26,15,11,21,61,86,0
315,Alessandro Bianco,ITA,MF,Monza,it  Serie A,22-161,2002.0,19.9,37,22,13,16,8,21,30,70.0,9,29,12,17,11,48,37,4
316,Alessandro Bianco,ITA,MF,Fiorentina,it  Serie A,22-161,2002.0,0.2,0,0,0,0,0,0,1,0.0,1,0,0,0,0,0,0,0
317,Mika Biereth,DEN,FW,Monaco,fr  Ligue 1,22-031,2003.0,7.1,2,2,0,1,1,2,4,50.0,2,6,0,6,2,4,5,0
318,Jaka Bijol,SVN,DF,Udinese,it  Serie A,26-034,1999.0,26.0,36,19,27,8,1,16,30,53.3,14,31,15,16,31,67,130,1
319,El Bilal Touré,MLI,"FW,MF",Stuttgart,de  Bundesliga,23-159,2001.0,3.5,3,1,1,1,1,3,3,100.0,0,1,0,1,0,3,1,0
320,Philip Billing,DEN,MF,Bournemouth,eng  Premier League,28-273,1996.0,2.0,14,5,7,6,1,3,4,75.0,1,3,0,3,5,19,2,0
321,Philip Billing,DEN,MF,Napoli,it  Serie A,28-273,1996.0,0.9,4,3,1,2,1,0,0,,0,1,0,1,1,5,4,0
322,Cristiano Biraghi,ITA,DF,Torino,it  Serie A,32-191,1992.0,3.2,1,1,0,0,1,0,1,0.0,1,2,0,2,3,4,19,0
323,Cristiano Biraghi,ITA,DF,Fiorentina,it  Serie A,32-191,1992.0,4.8,4,4,1,3,0,2,7,28.6,5,2,0,2,4,8,11,0
324,Samuele Birindelli,ITA,"DF,MF",Monza,it  Serie A,25-235,1999.0,7.7,12,9,4,4,4,3,6,50.0,3,4,1,3,6,18,18,0
325,Tom Bischof,GER,"MF,FW",Hoffenheim,de  Bundesliga,19-256,2005.0,20.8,82,45,28,41,13,33,66,50.0,33,48,7,41,24,106,35,1
326,Yves Bissouma,MLI,MF,Tottenham,eng  Premier League,28-193,1996.0,12.2,39,26,15,21,3,16,30,53.3,14,7,4,3,14,53,31,4
327,Leonardo Bittencourt,GER,MF,Werder Bremen,de  Bundesliga,31-082,1993.0,9.5,23,9,13,7,3,6,15,40.0,9,8,0,8,11,34,10,0
328,Emmanuel Biumla,FRA,DF,Angers,fr  Ligue 1,19-307,2005.0,14.6,19,12,14,5,0,12,18,66.7,6,18,8,10,8,27,83,1
329,Marco Bizot,NED,GK,Brest,fr  Ligue 1,34-001,1991.0,24.0,2,1,2,0,0,1,1,100.0,0,0,0,0,0,2,20,0
330,Bjarki Bjarkason,ISL,"DF,MF",Venezia,it  Serie A,24-304,2000.0,1.8,3,2,2,1,0,1,2,50.0,1,1,0,1,2,5,4,0
331,Antonio Blanco,ESP,MF,Alavés,es  La Liga,24-231,2000.0,20.7,45,29,15,28,2,26,58,44.8,32,23,6,17,30,75,35,1
332,Ludovic Blas,FRA,"MF,FW",Rennes,fr  Ligue 1,27-070,1997.0,22.2,34,21,7,12,15,21,39,53.8,18,16,2,14,12,46,9,0
333,Daley Blind,NED,DF,Girona,es  La Liga,35-002,1990.0,19.9,32,17,16,12,4,19,31,61.3,12,26,8,18,19,51,59,1
334,Myron Boadu,NED,FW,Bochum,de  Bundesliga,24-056,2001.0,6.5,2,1,0,0,2,1,4,25.0,3,1,0,1,0,2,3,0
335,Augustine Boakye,GHA,"FW,MF",Saint-Étienne,fr  Ligue 1,24-128,2000.0,8.1,7,3,3,4,0,3,11,27.3,8,5,0,5,6,13,4,0
336,Mathéo Bodmer,FRA,MF,Le Havre,fr  Ligue 1,20-309,2004.0,0.1,0,0,0,0,0,0,0,,0,0,0,0,0,0,1,0
337,Sacha Boey,FRA,DF,Bayern Munich,de  Bundesliga,24-179,2000.0,4.7,14,4,5,2,7,7,10,70.0,3,3,0,3,2,16,7,0
338,Jeremie Boga,CIV,"MF,FW",Nice,fr  Ligue 1,28-067,1997.0,7.5,7,5,1,5,1,2,3,66.7,1,11,0,11,2,9,2,0
339,Lamare Bogarde,NED,"DF,MF",Aston Villa,eng  Premier League,21-065,2004.0,5.3,14,6,6,6,2,10,16,62.5,6,5,3,2,1,15,13,0
340,Emil Bohinen,NOR,MF,Genoa,it  Serie A,25-364,1999.0,1.8,4,4,3,0,1,2,5,40.0,3,2,0,2,1,5,6,0
341,Adama Boiro,ESP,DF,Athletic Club,es  La Liga,22-262,2002.0,8.5,15,7,8,5,2,7,10,70.0,3,7,3,4,8,23,24,1
342,Willy Boly,CIV,DF,Nott'ham Forest,eng  Premier League,34-036,1991.0,1.5,5,1,4,1,0,4,4,100.0,0,3,1,2,3,8,12,0
343,Moïse Bombito,CAN,DF,Nice,fr  Ligue 1,24-346,2000.0,18.2,27,17,15,10,2,21,30,70.0,9,25,12,13,12,39,93,4
344,Warren Bondo,FRA,MF,Monza,it  Serie A,21-177,2003.0,18.0,35,24,19,12,4,13,19,68.4,6,16,6,10,5,40,8,4
345,Warren Bondo,FRA,MF,Milan,it  Serie A,21-177,2003.0,0.7,2,1,2,0,0,1,1,100.0,0,1,0,1,0,2,2,0
346,Victor Boniface,NGA,FW,Leverkusen,de  Bundesliga,24-078,2000.0,8.9,4,3,0,3,1,2,2,100.0,0,1,0,1,0,4,4,0
347,Kevin Bonifazi,ITA,DF,Lecce,it  Serie A,28-296,1996.0,0.7,1,1,1,0,0,1,1,100.0,0,1,1,0,2,3,3,0
348,Ange-Yoan Bonny,FRA,FW,Parma,it  Serie A,21-137,2003.0,20.1,20,10,2,15,3,6,11,54.5,5,12,1,11,1,21,10,0
349,Sebastiaan Bornauw,BEL,DF,Wolfsburg,de  Bundesliga,25-354,1999.0,7.7,7,4,2,4,1,2,6,33.3,4,14,12,2,10,17,30,0
350,Sven Botman,NED,DF,Newcastle Utd,eng  Premier League,25-058,2000.0,2.5,5,3,2,3,0,2,3,66.7,1,2,1,1,4,9,12,0
351,Saïmon Bouabré,FRA,"MF,FW",Monaco,fr  Ligue 1,18-283,2006.0,0.8,0,0,0,0,0,0,3,0.0,3,1,0,1,0,0,0,0
352,Ayyoub Bouaddi,FRA,MF,Lille,fr  Ligue 1,17-160,2007.0,11.3,47,29,21,19,7,18,30,60.0,12,10,3,7,9,56,9,1
353,Badredine Bouanani,ALG,"MF,FW",Nice,fr  Ligue 1,20-093,2004.0,7.6,6,3,2,3,1,1,9,11.1,8,12,3,9,6,12,4,0
354,Benjamin Bouchouari,MAR,MF,Saint-Étienne,fr  Ligue 1,23-118,2001.0,15.4,25,20,10,11,4,13,34,38.2,21,17,1,16,17,42,11,2
355,Hicham Boudaoui,ALG,MF,Nice,fr  Ligue 1,25-169,1999.0,19.0,53,32,20,25,8,21,39,53.8,18,30,6,24,19,72,37,0
356,Carlo Boukhalfa,MAR,MF,St. Pauli,de  Bundesliga,25-312,1999.0,13.6,19,6,5,13,1,5,15,33.3,10,17,3,14,11,30,19,1
357,Justin Bourgault,FRA,DF,Brest,fr  Ligue 1,19-178,2005.0,0.9,1,0,1,0,0,0,0,,0,0,0,0,0,1,1,0
358,Benjamin Bourigeaud,FRA,MF,Rennes,fr  Ligue 1,31-056,1994.0,0.9,1,0,0,1,0,0,2,0.0,2,2,1,1,2,3,1,0
359,Edoardo Bove,ITA,"MF,FW",Fiorentina,it  Serie A,22-299,2002.0,9.5,24,17,7,14,3,14,28,50.0,14,12,0,12,6,30,8,0
360,Jarrod Bowen,ENG,"FW,MF",West Ham,eng  Premier League,28-081,1996.0,23.3,32,20,11,9,12,14,34,41.2,20,17,3,14,13,45,19,0
361,Enzo Boyomo,CMR,DF,Osasuna,es  La Liga,23-155,2001.0,21.7,44,31,28,13,3,19,23,82.6,4,26,15,11,26,70,81,2
362,Enzo Boyomo,CMR,DF,Valladolid,es  La Liga,23-155,2001.0,3.0,6,2,4,2,0,3,3,100.0,0,4,3,1,1,7,7,0
363,Domagoj Bradarić,CRO,DF,Hellas Verona,it  Serie A,25-091,1999.0,13.2,24,17,15,6,3,11,20,55.0,9,13,4,9,9,33,36,1
364,Conor Bradley,NIR,DF,Liverpool,eng  Premier League,21-245,2003.0,4.1,6,3,3,2,1,5,12,41.7,7,2,0,2,3,9,16,0
365,Bilal Brahimi,ALG,MF,Nice,fr  Ligue 1,24-362,2000.0,0.8,0,0,0,0,0,0,0,,0,1,0,1,0,0,2,0
366,Julian Brandt,GER,MF,Dortmund,de  Bundesliga,28-313,1996.0,18.1,15,7,8,6,1,10,22,45.5,12,13,0,13,9,24,7,1
367,Jarrad Branthwaite,ENG,DF,Everton,eng  Premier League,22-257,2002.0,19.1,30,17,23,7,0,16,20,80.0,4,23,17,6,23,53,132,3
368,Darko Brašanac,SRB,MF,Leganés,es  La Liga,33-027,1992.0,14.5,23,10,4,13,6,8,14,57.1,6,17,9,8,13,36,31,0
369,Lilian Brassier,FRA,DF,Marseille,fr  Ligue 1,25-129,1999.0,8.7,8,6,8,0,0,5,6,83.3,1,8,3,5,9,17,28,2
370,Lilian Brassier,FRA,DF,Rennes,fr  Ligue 1,25-129,1999.0,5.7,3,3,3,0,0,2,2,100.0,0,8,5,3,16,19,29,0
371,Matthias Braunöder,AUT,MF,Como,it  Serie A,22-349,2002.0,3.0,10,4,6,3,1,7,11,63.6,4,3,0,3,2,12,4,1
372,Iker Bravo,ESP,"FW,MF",Udinese,it  Serie A,20-057,2005.0,4.2,8,5,2,5,1,4,8,50.0,4,1,0,1,0,8,4,0
373,James Bree,ENG,DF,Southampton,eng  Premier League,27-151,1997.0,9.9,15,10,5,9,1,7,17,41.2,10,8,3,5,8,23,24,0
374,Tim Breithaupt,GER,MF,Augsburg,de  Bundesliga,23-032,2002.0,1.3,1,1,0,1,0,0,4,0.0,4,1,0,1,2,3,0,0
375,Gleison Bremer,BRA,DF,Juventus,it  Serie A,27-358,1997.0,6.0,15,7,9,5,1,4,5,80.0,1,15,11,4,6,21,16,0
376,Brenner,BRA,"MF,FW",Udinese,it  Serie A,25-054,2000.0,4.3,6,4,2,3,1,3,8,37.5,5,4,0,4,1,7,6,0
377,Ben Brereton,CHI,FW,Southampton,eng  Premier League,25-327,1999.0,5.0,3,2,0,2,1,1,9,11.1,8,2,1,1,0,3,4,0
378,Marco Brescianini,ITA,MF,Atalanta,it  Serie A,25-050,2000.0,8.8,14,8,4,7,3,7,9,77.8,2,11,1,10,2,16,4,0
379,Maximilian Breunig,GER,"FW,MF",Heidenheim,de  Bundesliga,24-209,2000.0,3.9,4,3,1,2,1,3,6,50.0,3,9,2,7,1,5,3,0
380,Anthony Briançon,FRA,DF,Saint-Étienne,fr  Ligue 1,30-103,1994.0,0.0,0,0,0,0,0,0,0,,0,0,0,0,0,0,0,0
381,Nathan Broadhead,WAL,"FW,MF",Ipswich Town,eng  Premier League,26-340,1998.0,4.9,4,2,1,3,0,2,6,33.3,4,3,0,3,4,8,5,0
382,Armando Broja,ALB,FW,Everton,eng  Premier League,23-182,2001.0,1.8,2,1,1,1,0,0,0,,0,3,0,3,0,2,3,0
383,David Brooks,WAL,FW,Bournemouth,eng  Premier League,27-246,1997.0,8.0,10,3,2,5,3,1,10,10.0,9,14,2,12,4,14,7,1
384,Arvid Brorsson,SWE,DF,Monza,it  Serie A,25-307,1999.0,1.2,2,2,1,1,0,2,2,100.0,0,5,4,1,0,2,13,1
385,Moritz Broschinski,GER,"FW,MF",Bochum,de  Bundesliga,24-169,2000.0,13.8,18,14,6,6,6,5,14,35.7,9,15,0,15,1,19,17,0
386,Nathaniel Brown,GER,"DF,MF",Eint Frankfurt,de  Bundesliga,21-268,2003.0,13.4,43,31,23,12,8,30,36,83.3,6,18,0,18,10,53,39,0
387,Jacob Bruun Larsen,DEN,"FW,MF",Hoffenheim,de  Bundesliga,26-173,1998.0,4.4,4,3,1,2,1,3,8,37.5,5,5,1,4,1,5,2,0
388,Jacob Bruun Larsen,DEN,MF,Stuttgart,de  Bundesliga,26-173,1998.0,3.8,1,1,1,0,0,0,2,0.0,2,5,0,5,1,2,3,1
389,Tajon Buchanan,CAN,"DF,FW",Inter,it  Serie A,26-031,1999.0,1.1,3,0,2,0,1,1,2,50.0,1,0,0,0,0,3,3,0
390,Tajon Buchanan,CAN,"MF,FW",Villarreal,es  La Liga,26-031,1999.0,0.6,5,2,4,1,0,4,6,66.7,2,2,0,2,1,6,1,0
391,Ante Budimir,CRO,FW,Osasuna,es  La Liga,33-232,1991.0,22.1,15,7,3,8,4,2,8,25.0,6,16,4,12,1,16,13,0
392,Emi Buendía,ARG,"MF,FW",Aston Villa,eng  Premier League,28-076,1996.0,1.1,6,6,3,2,1,0,5,0.0,5,5,1,4,0,6,2,0
393,Emi Buendía,ARG,"MF,FW",Leverkusen,de  Bundesliga,28-076,1996.0,1.3,3,2,1,1,1,3,5,60.0,2,1,0,1,0,3,0,0
394,Manu Bueno,ESP,MF,Sevilla,es  La Liga,20-227,2004.0,1.2,4,3,0,1,3,1,2,50.0,1,0,0,0,0,4,2,0
395,Santiago Bueno,URU,DF,Wolves,eng  Premier League,26-122,1998.0,16.8,32,16,21,10,1,13,17,76.5,4,32,18,14,14,46,54,0
396,Endika Buján,ESP,FW,Athletic Club,es  La Liga,22-054,2003.0,0.1,0,0,0,0,0,0,1,0.0,1,0,0,0,0,0,0,0
397,Marius Bülter,GER,"FW,DF",Hoffenheim,de  Bundesliga,31-347,1993.0,12.3,7,7,1,4,2,6,10,60.0,4,4,1,3,1,8,5,0
398,Facundo Buonanotte,ARG,"FW,MF",Leicester City,eng  Premier League,20-078,2004.0,14.4,46,25,15,18,13,20,62,32.3,42,31,6,25,10,56,11,0
399,Alessandro Buongiorno,ITA,DF,Napoli,it  Serie A,25-278,1999.0,18.7,33,19,21,11,1,21,26,80.8,5,26,15,11,30,63,55,2
400,Cameron Burgess,AUS,DF,Ipswich Town,eng  Premier League,29-141,1995.0,10.0,9,7,7,2,0,5,5,100.0,0,14,11,3,9,18,67,1
401,Jonathan Burkardt,GER,FW,Mainz 05,de  Bundesliga,24-243,2000.0,15.8,9,6,1,3,5,2,5,40.0,3,7,1,6,1,10,13,0
402,Oliver Burke,SCO,"FW,MF",Werder Bremen,de  Bundesliga,27-338,1997.0,3.8,8,3,4,0,4,2,3,66.7,1,6,0,6,2,10,4,0
403,Dan Burn,ENG,DF,Newcastle Utd,eng  Premier League,32-306,1992.0,27.0,31,17,18,12,1,17,32,53.1,15,26,20,6,18,49,138,3
404,Rareș-Cătălin Burnete,ROU,FW,Lecce,it  Serie A,21-039,2004.0,0.2,0,0,0,0,0,0,1,0.0,1,0,0,0,0,0,0,0
405,Wes Burns,WAL,"FW,DF",Ipswich Town,eng  Premier League,30-108,1994.0,10.3,13,11,1,9,3,4,10,40.0,6,7,2,5,10,23,13,2
406,Marnon Busch,GER,DF,Heidenheim,de  Bundesliga,30-093,1994.0,9.6,14,10,9,5,0,13,18,72.2,5,16,6,10,9,23,49,3
407,Gianluca Busio,USA,MF,Venezia,it  Serie A,22-287,2002.0,20.4,36,24,21,8,7,18,41,43.9,23,24,6,18,11,47,36,0
408,Aurélio Buta,POR,DF,Reims,fr  Ligue 1,28-029,1997.0,16.5,33,21,20,10,3,19,35,54.3,16,11,2,9,17,50,43,0
409,Jean Butez,FRA,GK,Como,it  Serie A,29-276,1995.0,10.0,0,0,0,0,0,0,0,,0,0,0,0,0,0,7,1
410,Marcin Bułka,POL,GK,Nice,fr  Ligue 1,25-158,1999.0,25.0,0,0,0,0,0,0,1,0.0,1,0,0,0,0,0,11,6
411,Pau Cabanes,ESP,"MF,FW",Villarreal,es  La Liga,20-022,2005.0,1.8,4,4,0,3,1,3,4,75.0,1,5,0,5,3,7,2,1
412,Pau Cabanes,ESP,MF,Alavés,es  La Liga,20-022,2005.0,1.5,4,2,3,0,1,4,9,44.4,5,1,0,1,0,4,0,0
413,Rémy Cabella,FRA,"FW,MF",Lille,fr  Ligue 1,35-003,1990.0,9.9,33,17,14,10,9,17,29,58.6,12,9,1,8,8,41,4,0
414,Leandro Cabrera,URU,DF,Espanyol,es  La Liga,33-267,1991.0,21.0,31,16,23,7,1,12,21,57.1,9,24,15,9,26,57,126,1
415,Liberato Cacace,NZL,"DF,MF",Empoli,it  Serie A,24-165,2000.0,16.4,27,20,17,9,1,17,26,65.4,9,21,7,14,11,38,48,0
416,Anthony Caci,FRA,DF,Mainz 05,de  Bundesliga,27-253,1997.0,21.9,52,34,21,20,11,25,36,69.4,11,24,6,18,16,68,39,2
417,Mathieu Cafaro,FRA,"MF,FW",Saint-Étienne,fr  Ligue 1,27-351,1997.0,8.1,10,7,4,4,2,4,15,26.7,11,7,1,6,7,17,3,0
418,Moisés Caicedo,ECU,MF,Chelsea,eng  Premier League,23-129,2001.0,27.2,82,49,31,41,10,41,66,62.1,25,37,9,28,39,121,38,0
419,Tom Cairney,SCO,MF,Fulham,eng  Premier League,34-050,1991.0,4.7,7,2,2,2,3,2,5,40.0,3,3,1,2,4,11,1,1
420,Jens Cajuste,SWE,MF,Ipswich Town,eng  Premier League,25-213,1999.0,14.9,31,15,14,16,1,14,38,36.8,24,18,5,13,19,50,21,2
421,Davide Calabria,ITA,DF,Bologna,it  Serie A,28-095,1996.0,3.1,5,2,2,3,0,2,5,40.0,3,2,0,2,0,5,7,0
422,Davide Calabria,ITA,DF,Milan,it  Serie A,28-095,1996.0,3.5,10,7,10,0,0,4,7,57.1,3,1,0,1,8,18,8,0
423,Riccardo Calafiori,ITA,DF,Arsenal,eng  Premier League,22-296,2002.0,10.3,26,18,15,9,2,18,29,62.1,11,12,6,6,9,35,25,0
424,Luca Caldirola,ITA,DF,Monza,it  Serie A,34-038,1991.0,5.4,6,3,5,1,0,2,5,40.0,3,6,5,1,4,10,22,0
425,Fernando Calero,ESP,"DF,MF",Espanyol,es  La Liga,29-178,1995.0,4.1,7,3,6,1,0,3,4,75.0,1,8,5,3,11,18,25,0
426,Duje Ćaleta-Car,CRO,DF,Lyon,fr  Ligue 1,28-175,1996.0,13.9,16,8,8,8,0,8,15,53.3,7,27,21,6,13,29,73,2
427,Hakan Çalhanoğlu,TUR,MF,Inter,it  Serie A,31-031,1994.0,14.3,32,16,5,17,10,15,26,57.7,11,9,5,4,13,45,11,0
428,Dominic Calvert-Lewin,ENG,FW,Everton,eng  Premier League,27-360,1997.0,17.5,9,7,1,4,4,2,6,33.3,4,6,2,4,6,15,18,0
429,Drissa Camara,CIV,"MF,FW",Parma,it  Serie A,23-021,2002.0,4.2,9,7,2,6,1,1,9,11.1,8,6,0,6,2,11,1,0
430,Issiaga Camara,GUI,MF,Nice,fr  Ligue 1,20-037,2005.0,0.2,2,1,0,2,0,0,1,0.0,1,0,0,0,3,5,0,0
431,Lamine Camara,SEN,MF,Monaco,fr  Ligue 1,21-069,2004.0,16.4,49,31,14,27,8,19,35,54.3,16,23,4,19,23,72,22,1
432,Mahdi Camara,FRA,"MF,FW",Brest,fr  Ligue 1,26-254,1998.0,21.0,57,33,13,30,14,17,34,50.0,17,34,3,31,24,81,23,0
433,Francesco Camarda,ITA,"FW,MF",Milan,it  Serie A,17-001,2008.0,1.8,5,2,0,2,3,2,6,33.3,4,1,1,0,0,5,3,0
434,Eduardo Camavinga,FRA,"MF,DF",Real Madrid,es  La Liga,22-121,2002.0,7.6,30,17,16,11,3,16,23,69.6,7,13,5,8,8,38,13,0
435,Nicolò Cambiaghi,ITA,FW,Bologna,it  Serie A,24-073,2000.0,2.5,5,3,2,3,0,1,3,33.3,2,5,0,5,2,7,1,0
436,Andrea Cambiaso,ITA,"DF,FW",Juventus,it  Serie A,25-019,2000.0,19.9,38,23,23,9,6,24,39,61.5,15,19,3,16,12,50,27,4
437,Axel Camblan,FRA,"MF,FW",Brest,fr  Ligue 1,21-193,2003.0,0.3,1,1,0,0,1,1,2,50.0,1,1,0,1,0,1,0,0
438,Sergio Camello,ESP,FW,Rayo Vallecano,es  La Liga,24-029,2001.0,12.6,9,3,2,5,2,4,6,66.7,2,8,1,7,4,13,16,0
439,José Campaña,ESP,MF,Las Palmas,es  La Liga,31-284,1993.0,10.3,16,14,6,8,2,8,13,61.5,5,6,0,6,17,33,18,1
440,Thomas Campaniello,ITA,FW,Empoli,it  Serie A,17-010,2008.0,0.3,0,0,0,0,0,0,1,0.0,1,0,0,0,0,0,0,0
441,Cole Campbell,USA,"MF,FW",Dortmund,de  Bundesliga,19-019,2006.0,0.2,0,0,0,0,0,0,0,,0,0,0,0,0,0,1,0
442,Emre Can,GER,"DF,MF",Dortmund,de  Bundesliga,31-058,1994.0,17.7,38,23,25,11,2,12,24,50.0,12,15,8,7,15,53,54,3
443,Peio Canales,ESP,"MF,FW",Athletic Club,es  La Liga,20-053,2005.0,1.3,2,2,0,0,2,1,1,100.0,0,0,0,0,2,4,1,0
444,Matteo Cancellieri,ITA,"FW,MF",Parma,it  Serie A,23-027,2002.0,15.8,26,16,15,9,2,11,32,34.4,21,15,1,14,13,39,30,0
445,Fali Candé,GNB,DF,Venezia,it  Serie A,27-046,1998.0,7.0,13,12,10,2,1,8,11,72.7,3,10,7,3,5,18,35,0
446,Antonio Candela,ITA,DF,Venezia,it  Serie A,24-318,2000.0,11.2,31,21,13,11,7,18,26,69.2,8,7,5,2,8,39,22,2
447,Antonio Candela,ITA,DF,Valladolid,es  La Liga,24-318,2000.0,3.0,6,4,4,1,1,1,1,100.0,0,2,1,1,2,8,8,0
448,Sergi Canós,ESP,"MF,FW",Valencia,es  La Liga,28-037,1997.0,4.0,11,7,3,4,4,4,10,40.0,6,5,1,4,5,16,4,0
449,Jaydee Canvot,FRA,"DF,MF",Toulouse,fr  Ligue 1,18-225,2006.0,8.1,16,7,9,5,2,9,14,64.3,5,8,2,6,7,23,24,1
450,Pierrick Capelle,FRA,MF,Angers,fr  Ligue 1,37-330,1987.0,4.6,21,15,10,6,5,8,17,47.1,9,4,1,3,9,30,5,1
451,Gianluca Caprari,ITA,"MF,FW",Monza,it  Serie A,31-224,1993.0,11.7,15,9,6,7,2,6,12,50.0,6,11,0,11,3,18,2,1
452,Elia Caprile,ITA,GK,Cagliari,it  Serie A,23-198,2001.0,9.0,0,0,0,0,0,0,1,0.0,1,0,0,0,0,0,1,1
453,Elia Caprile,ITA,GK,Napoli,it  Serie A,23-198,2001.0,3.6,0,0,0,0,0,0,0,,0,0,0,0,0,0,2,0
454,Gabin Capuano,FRA,FW,Lens,fr  Ligue 1,18-319,2006.0,0.1,0,0,0,0,0,0,0,,0,0,0,0,0,0,0,0
455,Francesco Caputo,ITA,FW,Empoli,it  Serie A,37-217,1987.0,0.1,0,0,0,0,0,0,0,,0,0,0,0,0,0,0,0
456,Maxence Caqueret,FRA,MF,Como,it  Serie A,25-024,2000.0,5.2,16,8,9,6,1,7,19,36.8,12,10,1,9,0,16,4,0
457,Maxence Caqueret,FRA,MF,Lyon,fr  Ligue 1,25-024,2000.0,6.4,21,11,5,11,5,4,22,18.2,18,12,2,10,7,28,2,0
458,Simon Cara,FRA,MF,Montpellier,fr  Ligue 1,19-284,2005.0,0.1,0,0,0,0,0,0,0,,0,0,0,0,0,0,0,0
459,Andrea Carboni,ITA,DF,Monza,it  Serie A,24-035,2001.0,18.5,41,22,25,13,3,21,37,56.8,16,22,11,11,21,62,78,3
460,Franco Carboni,ITA,DF,Venezia,it  Serie A,21-341,2003.0,2.0,5,3,5,0,0,5,6,83.3,1,1,1,0,0,5,11,0
461,Valentin Carboni,ARG,"MF,FW",Marseille,fr  Ligue 1,20-006,2005.0,1.1,2,2,0,1,1,0,1,0.0,1,1,0,1,1,3,1,0
462,Cárdenas,ESP,GK,Rayo Vallecano,es  La Liga,27-348,1997.0,5.0,0,0,0,0,0,0,0,,0,0,0,0,0,0,3,0
463,Irvin Cardona,FRA,"FW,MF",Espanyol,es  La Liga,27-215,1997.0,6.7,8,5,2,4,2,6,16,37.5,10,5,1,4,4,12,10,0
464,Irvin Cardona,FRA,FW,Saint-Étienne,fr  Ligue 1,27-215,1997.0,4.2,2,2,1,1,0,1,8,12.5,7,9,1,8,1,3,2,0
465,Marc Cardona,ESP,FW,Las Palmas,es  La Liga,29-246,1995.0,1.0,2,1,1,1,0,0,1,0.0,1,0,0,0,0,2,0,0
466,Sergi Cardona,ESP,DF,Villarreal,es  La Liga,25-246,1999.0,24.5,48,33,28,16,4,33,52,63.5,19,38,7,31,29,77,84,1
467,Johnny Cardoso,USA,MF,Betis,es  La Liga,23-172,2001.0,17.0,38,22,9,22,7,14,37,37.8,23,23,10,13,39,77,47,1
468,Tiago Cardoso,LUX,GK,Gladbach,de  Bundesliga,18-338,2006.0,1.0,0,0,0,0,0,0,0,,0,0,0,0,0,0,0,1
469,Patrik Carlgren,SWE,GK,Nantes,fr  Ligue 1,33-062,1992.0,3.0,0,0,0,0,0,0,0,,0,0,0,0,0,0,0,0
470,Diego Carlos,BRA,DF,Aston Villa,eng  Premier League,31-361,1993.0,9.2,8,3,6,1,1,4,6,66.7,2,13,7,6,5,13,36,2
471,Carmona,ESP,DF,Sevilla,es  La Liga,23-041,2002.0,24.2,59,42,33,20,6,27,52,51.9,25,29,9,20,53,112,74,3
472,Marco Carnesecchi,ITA,GK,Atalanta,it  Serie A,24-253,2000.0,25.0,0,0,0,0,0,0,0,,0,1,0,1,0,0,16,1
473,Sergio Carreira,ESP,"MF,DF",Celta Vigo,es  La Liga,24-149,2000.0,10.6,23,15,14,4,5,12,18,66.7,6,13,2,11,8,31,22,0
474,Dani Carvajal,ESP,DF,Real Madrid,es  La Liga,33-059,1992.0,6.8,12,8,7,3,2,9,12,75.0,3,8,3,5,10,22,19,1
475,Fabio Carvalho,POR,"FW,MF",Brentford,eng  Premier League,22-193,2002.0,5.1,13,9,4,4,5,6,13,46.2,7,6,1,5,3,16,2,0
476,William Carvalho,POR,MF,Betis,es  La Liga,32-338,1992.0,2.7,3,2,0,3,0,2,4,50.0,2,4,1,3,3,6,4,0
477,Cesare Casadei,ITA,MF,Torino,it  Serie A,22-060,2003.0,3.6,7,2,4,3,0,3,6,50.0,3,0,0,0,2,9,8,0
478,Marc Casado,ESP,MF,Barcelona,es  La Liga,21-178,2003.0,17.2,42,24,6,29,7,19,36,52.8,17,18,5,13,22,64,21,1
479,Nicolò Casale,ITA,DF,Bologna,it  Serie A,27-025,1998.0,6.7,7,4,4,3,0,3,7,42.9,4,10,6,4,9,16,33,2
480,Nicolò Casale,ITA,DF,Lazio,it  Serie A,27-025,1998.0,1.5,5,3,4,1,0,0,0,,0,4,3,1,1,6,2,0
481,Casemiro,BRA,MF,Manchester Utd,eng  Premier League,33-016,1992.0,12.2,62,36,36,17,9,34,58,58.6,24,30,8,22,10,72,39,3
482,Kaelan Casey,ENG,DF,West Ham,eng  Premier League,20-134,2004.0,0.0,0,0,0,0,0,0,0,,0,0,0,0,0,0,1,0
483,Matty Cash,POL,"DF,FW",Aston Villa,eng  Premier League,27-216,1997.0,15.5,40,23,22,16,2,18,28,64.3,10,16,5,11,18,58,38,2
484,Josué Casimir,FRA,"MF,FW",Le Havre,fr  Ligue 1,23-168,2001.0,13.5,24,15,10,11,3,7,15,46.7,8,9,0,9,3,27,27,1
485,Federico Cassa,ITA,"MF,FW",Atalanta,it  Serie A,19-038,2006.0,0.2,0,0,0,0,0,0,0,,0,1,0,1,0,0,0,0
486,Cristian Cásseres Jr.,VEN,MF,Toulouse,fr  Ligue 1,25-050,2000.0,21.2,80,52,39,32,9,37,68,54.4,31,28,6,22,28,108,31,1
487,Timothy Castagne,BEL,DF,Fulham,eng  Premier League,29-096,1995.0,13.9,35,21,19,14,2,19,30,63.3,11,11,3,8,16,51,62,0
488,Valentín Castellanos,ARG,FW,Lazio,it  Serie A,26-159,1998.0,19.7,9,4,1,3,5,1,9,11.1,8,15,2,13,5,14,19,0
489,Jean-Charles Castelletto,CMR,"DF,MF",Nantes,fr  Ligue 1,30-044,1995.0,22.3,28,12,13,13,2,14,20,70.0,6,21,15,6,23,51,119,0
490,Santiago Castro,ARG,FW,Bologna,it  Serie A,20-163,2004.0,22.7,17,9,4,9,4,5,13,38.5,8,12,2,10,3,20,19,0
491,Gaetano Castrovilli,ITA,"MF,FW",Monza,it  Serie A,28-022,1997.0,1.6,4,3,2,2,0,2,6,33.3,4,2,1,1,2,6,3,0
492,Gaetano Castrovilli,ITA,"MF,FW",Lazio,it  Serie A,28-022,1997.0,1.6,5,2,3,1,1,2,4,50.0,2,3,0,3,3,8,1,0
493,Danilo Cataldi,ITA,MF,Fiorentina,it  Serie A,30-217,1994.0,13.4,18,13,7,9,2,8,18,44.4,10,10,4,6,16,34,21,0
494,Catena,ESP,DF,Osasuna,es  La Liga,30-134,1994.0,23.8,35,22,26,7,2,19,33,57.6,14,27,16,11,22,57,154,0
495,Maximiliano Caufriez,BEL,DF,Valencia,es  La Liga,28-023,1997.0,1.0,1,1,1,0,0,1,1,100.0,0,2,1,1,1,2,4,0
496,Dani Ceballos,ESP,MF,Real Madrid,es  La Liga,28-216,1996.0,9.2,34,18,15,14,5,16,26,61.5,10,13,3,10,13,47,6,1
497,Abdoulie Ceesay,GAM,FW,St. Pauli,de  Bundesliga,21-065,2004.0,0.6,3,3,1,1,1,2,3,66.7,1,1,0,1,0,3,1,0
498,Zeki Çelik,TUR,DF,Roma,it  Serie A,28-022,1997.0,17.4,40,23,13,20,7,16,29,55.2,13,21,5,16,9,49,57,1
499,Fabien Centonze,FRA,DF,Nantes,fr  Ligue 1,29-054,1996.0,0.9,3,1,1,1,1,1,3,33.3,2,1,0,1,1,4,7,0
500,Alberto Cerri,ITA,FW,Como,it  Serie A,28-329,1996.0,1.0,0,0,0,0,0,0,0,,0,2,0,2,0,0,1,0
501,Franco Cervi,ARG,"FW,MF",Celta Vigo,es  La Liga,30-289,1994.0,2.9,8,3,2,6,0,3,7,42.9,4,4,0,4,8,16,6,0
502,Julian Chabot,GER,DF,Stuttgart,de  Bundesliga,27-027,1998.0,18.1,27,17,14,11,2,11,24,45.8,13,19,12,7,28,55,100,0
503,El Chadaille Bitshiabu,FRA,DF,RB Leipzig,de  Bundesliga,19-299,2005.0,6.2,15,10,7,7,1,5,8,62.5,3,7,3,4,7,22,45,1
504,Fares Chaïbi,ALG,"MF,FW",Eint Frankfurt,de  Bundesliga,22-103,2002.0,7.9,11,7,4,4,3,6,13,46.2,7,9,0,9,7,18,27,1
505,Trevoh Chalobah,ENG,DF,Crystal Palace,eng  Premier League,25-249,1999.0,11.8,20,16,7,12,1,12,23,52.2,11,19,9,10,19,39,57,3
506,Trevoh Chalobah,ENG,DF,Chelsea,eng  Premier League,25-249,1999.0,3.3,3,1,0,3,0,2,2,100.0,0,1,1,0,6,9,13,1
507,Timothy Chandler,USA,DF,Eint Frankfurt,de  Bundesliga,34-347,1990.0,0.2,0,0,0,0,0,0,0,,0,0,0,0,3,3,2,0
508,Conor Chaplin,ENG,"MF,FW",Ipswich Town,eng  Premier League,28-023,1997.0,6.8,11,5,3,6,2,6,13,46.2,7,8,1,7,3,14,2,0
509,Brendan Chardonnet,FRA,DF,Brest,fr  Ligue 1,30-079,1994.0,21.8,35,26,21,11,3,20,33,60.6,13,37,21,16,24,59,136,2
510,Gabriel Charpentier,CGO,FW,Parma,it  Serie A,25-298,1999.0,3.0,4,3,2,1,1,3,4,75.0,1,3,0,3,0,4,9,0
511,Raúl Chasco,ESP,DF,Valladolid,es  La Liga,21-179,2003.0,1.4,4,1,3,1,0,2,4,50.0,2,1,0,1,2,6,2,0
512,Anrie Chase,JPN,DF,Stuttgart,de  Bundesliga,20-352,2004.0,8.2,10,4,6,4,0,5,7,71.4,2,10,6,4,9,19,35,0
513,Pep Chavarría,ESP,DF,Rayo Vallecano,es  La Liga,26-335,1998.0,19.3,33,24,22,10,1,19,31,61.3,12,30,8,22,20,53,79,1
514,Arthur Chaves,BRA,DF,Hoffenheim,de  Bundesliga,24-041,2001.0,16.4,28,19,14,11,3,14,33,42.4,19,35,13,22,25,53,87,2
515,Jhoanner Chávez,ECU,"DF,MF",Lens,fr  Ligue 1,22-320,2002.0,6.6,9,5,4,4,1,2,7,28.6,5,10,1,9,6,15,13,0
516,Walid Cheddira,MAR,FW,Napoli,it  Serie A,27-048,1998.0,0.1,0,0,0,0,0,0,0,,0,0,0,0,0,0,0,0
517,Walid Cheddira,MAR,FW,Espanyol,es  La Liga,27-048,1998.0,6.6,4,0,0,1,3,0,1,0.0,1,3,0,3,1,5,6,0
518,Chema,ESP,MF,Real Madrid,es  La Liga,19-320,2005.0,0.1,0,0,0,0,0,0,0,,0,0,0,0,0,0,1,0
519,Théo Chennahi,FRA,"MF,DF",Montpellier,fr  Ligue 1,20-033,2005.0,0.1,0,0,0,0,0,0,0,,0,1,0,1,0,0,0,0
520,Sidiki Cherif,FRA,FW,Angers,fr  Ligue 1,18-086,2006.0,3.6,5,5,1,3,1,3,4,75.0,1,4,1,3,0,5,0,1
521,Rayan Cherki,FRA,"FW,MF",Lyon,fr  Ligue 1,21-206,2003.0,14.8,10,9,3,6,1,4,17,23.5,13,6,0,6,5,15,6,0
522,Lucas Chevalier,FRA,GK,Lille,fr  Ligue 1,23-125,2001.0,25.0,3,2,3,0,0,3,4,75.0,1,0,0,0,0,3,6,1
523,Fabio Chiarodia,ITA,DF,Gladbach,de  Bundesliga,19-279,2005.0,0.7,2,1,1,1,0,1,1,100.0,0,1,0,1,3,5,12,0
524,Julián Chicco,ARG,MF,Leganés,es  La Liga,27-057,1998.0,2.2,8,5,1,6,1,4,6,66.7,2,2,0,2,2,10,3,0
525,Leandro Chichizola,ARG,GK,Parma,it  Serie A,34-349,1990.0,1.0,0,0,0,0,0,0,0,,0,0,0,0,0,0,2,0
526,Federico Chiesa,ITA,FW,Liverpool,eng  Premier League,27-137,1997.0,0.3,0,0,0,0,0,0,1,0.0,1,1,0,1,0,0,0,0
527,Ben Chilwell,ENG,"DF,MF",Crystal Palace,eng  Premier League,28-080,1996.0,0.6,2,2,1,1,0,0,1,0.0,1,0,0,0,0,2,6,0
528,Chiquinho,POR,MF,Wolves,eng  Premier League,25-034,2000.0,0.1,0,0,0,0,0,0,0,,0,0,0,0,0,0,0,0
529,Chiquinho,POR,"MF,FW",Mallorca,es  La Liga,25-034,2000.0,1.6,1,0,0,1,0,0,7,0.0,7,3,0,3,2,3,0,0
530,Pedro Chirivella,ESP,MF,Nantes,fr  Ligue 1,27-292,1997.0,20.0,31,22,14,14,3,14,31,45.2,17,19,3,16,14,45,37,0
531,Joris Chotard,FRA,MF,Montpellier,fr  Ligue 1,23-168,2001.0,15.3,31,20,15,15,1,17,37,45.9,20,24,6,18,14,45,44,0
532,Hamza Choudhury,ENG,"MF,DF",Leicester City,eng  Premier League,27-161,1997.0,1.5,1,1,1,0,0,1,3,33.3,2,4,2,2,5,6,2,0
533,Andreas Christensen,DEN,DF,Barcelona,es  La Liga,28-335,1996.0,0.3,0,0,0,0,0,0,0,,0,0,0,0,0,0,2,0
534,Ryan Christie,SCO,MF,Bournemouth,eng  Premier League,30-017,1995.0,22.2,52,33,18,26,8,27,62,43.5,35,42,11,31,30,82,50,3
535,Carney Chukwuemeka,ENG,"MF,FW",Dortmund,de  Bundesliga,21-142,2003.0,0.4,0,0,0,0,0,0,0,,0,1,0,1,0,0,1,0
536,Samuel Chukwueze,NGA,"FW,MF",Milan,it  Serie A,25-293,1999.0,8.9,12,7,5,3,4,5,16,31.3,11,3,0,3,2,14,7,0
537,Aaron Ciammaglichella,ITA,MF,Torino,it  Serie A,20-044,2005.0,0.0,0,0,0,0,0,0,0,,0,0,0,0,0,0,0,0
538,Jasper Cillessen,NED,GK,Las Palmas,es  La Liga,35-323,1989.0,24.7,1,0,1,0,0,1,3,33.3,2,0,0,0,0,1,11,2
539,Alessandro Circati,AUS,DF,Parma,it  Serie A,21-152,2003.0,4.0,4,2,3,1,0,1,1,100.0,0,5,4,1,2,6,29,1
540,Pathé Ciss,SEN,MF,Rayo Vallecano,es  La Liga,30-360,1994.0,14.7,36,18,17,18,1,18,36,50.0,18,21,5,16,21,57,42,2
541,Alphadjo Cissè,ITA,"FW,MF",Hellas Verona,it  Serie A,18-140,2006.0,0.1,0,0,0,0,0,0,0,,0,0,0,0,0,0,0,0
542,Djaoui Cissé,FRA,MF,Rennes,fr  Ligue 1,21-039,2004.0,4.4,14,9,6,4,4,8,14,57.1,6,10,3,7,7,21,4,0
543,Seydouba Cissé,GUI,MF,Leganés,es  La Liga,24-029,2001.0,19.2,37,24,16,15,6,14,31,45.2,17,19,1,18,10,47,34,1
544,Yoann Cissé,FRA,MF,Auxerre,fr  Ligue 1,20-088,2004.0,0.0,0,0,0,0,0,0,0,,0,0,0,0,0,0,0,0
545,Patrick Ciurria,ITA,"MF,DF",Monza,it  Serie A,30-030,1995.0,8.4,14,7,7,4,3,2,7,28.6,5,11,2,9,5,19,16,0
546,Harry Clarke,ENG,DF,Ipswich Town,eng  Premier League,24-009,2001.0,4.2,5,3,3,2,0,3,6,50.0,3,5,4,1,4,9,14,3
547,Jack Clarke,ENG,"FW,MF",Ipswich Town,eng  Premier League,24-108,2000.0,9.6,27,16,10,9,8,15,30,50.0,15,5,0,5,5,32,12,1
548,Alexis Claude-Maurice,FRA,"MF,FW",Augsburg,de  Bundesliga,26-278,1998.0,15.6,28,19,7,10,11,11,23,47.8,12,11,0,11,8,36,5,0
549,Jonathan Clauss,FRA,"DF,MF",Nice,fr  Ligue 1,32-167,1992.0,17.7,44,33,24,15,5,25,43,58.1,18,18,2,16,38,82,56,1
550,Silvi Clúa,ESP,MF,Girona,es  La Liga,20-041,2005.0,1.8,8,7,4,3,1,4,6,66.7,2,1,0,1,2,10,6,0
551,Nathaniel Clyne,ENG,"DF,MF",Crystal Palace,eng  Premier League,33-340,1991.0,4.4,11,7,7,3,1,5,7,71.4,2,4,2,2,3,14,12,1
552,Conor Coady,ENG,DF,Leicester City,eng  Premier League,32-014,1993.0,9.0,9,6,4,4,1,2,3,66.7,1,18,13,5,7,16,37,1
553,Marcus Coco,FRA,DF,Nantes,fr  Ligue 1,28-260,1996.0,9.1,24,20,14,7,3,15,30,50.0,15,13,3,10,6,30,36,0
554,Saúl Coco,EQG,DF,Torino,it  Serie A,26-030,1999.0,26.0,37,19,26,10,1,15,24,62.5,9,37,22,15,36,73,121,4
555,Séamus Coleman,IRL,DF,Everton,eng  Premier League,36-151,1988.0,2.2,2,1,1,1,0,2,3,66.7,1,5,3,2,1,3,7,0
556,Nathan Collins,IRL,DF,Brentford,eng  Premier League,23-315,2001.0,28.0,31,18,20,8,3,20,26,76.9,6,55,39,16,24,55,169,2
557,Nnamdi Collins,GER,DF,Eint Frankfurt,de  Bundesliga,21-060,2004.0,12.2,21,15,16,4,1,10,12,83.3,2,19,11,8,13,34,56,3
558,Toby Collyer,ENG,MF,Manchester Utd,eng  Premier League,21-067,2004.0,1.5,8,7,4,4,0,3,4,75.0,1,1,1,0,0,8,2,0
559,Lorenzo Colombo,ITA,"FW,MF",Empoli,it  Serie A,23-003,2002.0,21.2,23,12,5,12,6,6,20,30.0,14,29,2,27,2,25,14,1
560,Andrea Colpani,ITA,"FW,MF",Fiorentina,it  Serie A,25-304,1999.0,15.5,15,9,5,7,3,4,12,33.3,8,6,0,6,9,24,10,0
561,Levi Colwill,ENG,DF,Chelsea,eng  Premier League,22-013,2003.0,26.0,33,22,17,14,2,14,22,63.6,8,28,20,8,27,60,81,3
562,Florinel Coman,ROU,"FW,MF",Cagliari,it  Serie A,26-335,1998.0,1.5,4,3,2,1,1,2,2,100.0,0,1,0,1,1,5,0,0
563,Kingsley Coman,FRA,FW,Bayern Munich,de  Bundesliga,28-271,1996.0,11.5,15,10,5,5,5,6,10,60.0,4,7,0,7,7,22,14,0
564,Eray Cömert,SUI,"DF,MF",Valladolid,es  La Liga,27-035,1998.0,13.2,17,11,9,8,0,7,13,53.8,6,20,13,7,15,32,40,1
565,Santi Comesaña,ESP,MF,Villarreal,es  La Liga,28-157,1996.0,18.6,47,31,24,19,4,20,40,50.0,20,35,11,24,14,61,30,1
566,Pietro Comuzzo,ITA,DF,Fiorentina,it  Serie A,20-019,2005.0,21.1,36,17,22,11,3,18,24,75.0,6,27,17,10,24,60,95,4
567,Francisco Conceição,POR,FW,Juventus,it  Serie A,22-087,2002.0,11.2,15,8,4,6,5,7,23,30.4,16,5,0,5,4,19,4,0
568,Diego Conde,ESP,GK,Villarreal,es  La Liga,26-134,1998.0,19.8,2,2,2,0,0,2,4,50.0,2,0,0,0,1,3,9,2
569,Tomás Conechny,ARG,"FW,MF",Alavés,es  La Liga,26-346,1998.0,7.8,10,7,3,5,2,6,18,33.3,12,13,2,11,5,15,7,0
570,Alois Confais,FRA,MF,Le Havre,fr  Ligue 1,28-185,1996.0,0.0,0,0,0,0,0,0,0,,0,0,0,0,0,0,0,0
571,Sirlord Conteh,GER,"FW,MF",Heidenheim,de  Bundesliga,28-245,1996.0,7.6,9,5,3,6,0,2,6,33.3,4,1,1,0,1,10,6,0
572,Lewis Cook,ENG,"MF,DF",Bournemouth,eng  Premier League,28-036,1997.0,25.6,66,37,34,30,2,31,58,53.4,27,23,7,16,36,102,51,0
573,Copete,ESP,DF,Mallorca,es  La Liga,25-152,1999.0,10.3,15,9,11,4,0,6,6,100.0,0,11,7,4,9,24,73,1
574,Diego Coppola,ITA,DF,Hellas Verona,it  Serie A,21-073,2003.0,23.5,53,28,38,11,4,22,30,73.3,8,37,22,15,55,108,125,1
575,Francis Coquelin,FRA,"MF,FW",Nantes,fr  Ligue 1,33-302,1991.0,0.5,3,1,1,2,0,0,1,0.0,1,1,1,0,3,6,1,0
576,Iker Córdoba,ESP,DF,Valencia,es  La Liga,19-120,2005.0,0.2,0,0,0,0,0,0,0,,0,0,0,0,0,0,1,0
577,Derek Cornelius,CAN,DF,Marseille,fr  Ligue 1,27-106,1997.0,12.0,19,13,12,6,1,13,17,76.5,4,11,5,6,11,30,39,0
578,Maxwel Cornet,CIV,FW,Southampton,eng  Premier League,28-165,1996.0,0.8,5,5,1,4,0,0,4,0.0,4,0,0,0,0,5,2,0
579,Maxwel Cornet,CIV,"FW,MF",Genoa,it  Serie A,28-165,1996.0,2.6,2,1,1,0,1,0,1,0.0,1,1,1,0,2,4,1,0
580,Pierre Cornud,FRA,DF,Saint-Étienne,fr  Ligue 1,28-089,1996.0,6.4,12,10,6,4,2,8,17,47.1,9,9,4,5,9,21,28,1
581,Ángel Correa,ARG,"FW,MF",Atlético Madrid,es  La Liga,30-002,1995.0,7.7,7,1,3,1,3,3,13,23.1,10,8,0,8,4,11,7,0
582,Joaquín Correa,ARG,"FW,MF",Inter,it  Serie A,30-210,1994.0,2.8,5,1,2,3,0,1,4,25.0,3,1,0,1,0,5,2,0
583,Thierry Correia,POR,DF,Valencia,es  La Liga,26-002,1999.0,8.5,27,18,19,5,3,13,23,56.5,10,10,1,9,4,31,18,0
584,Alberto costa,POR,DF,Juventus,it  Serie A,21-163,2003.0,0.7,4,2,3,1,0,2,2,100.0,0,1,0,1,0,4,1,0
585,Coba da Costa,ESP,"MF,FW",Getafe,es  La Liga,22-228,2002.0,7.2,20,10,6,12,2,9,18,50.0,9,17,0,17,5,25,4,0
586,Danny da Costa,GER,DF,Mainz 05,de  Bundesliga,31-241,1993.0,14.0,31,18,17,11,3,11,16,68.8,5,14,7,7,12,43,63,2
587,David Costa,POR,"MF,FW",Lens,fr  Ligue 1,24-065,2001.0,3.9,2,0,1,1,0,1,4,25.0,3,5,1,4,1,3,0,0
588,Logan Costa,CPV,DF,Villarreal,es  La Liga,23-344,2001.0,17.8,29,16,18,10,1,18,21,85.7,3,15,8,7,12,41,63,1
589,Logan Costa,CPV,DF,Toulouse,fr  Ligue 1,23-344,2001.0,1.0,2,1,0,2,0,1,1,100.0,0,2,2,0,2,4,4,0
590,Samu Costa,POR,MF,Mallorca,es  La Liga,24-104,2000.0,20.0,60,28,31,28,1,22,52,42.3,30,33,10,23,22,82,59,0
591,Grégoire Coudert,FRA,GK,Brest,fr  Ligue 1,25-342,1999.0,1.0,0,0,0,0,0,0,0,,0,0,0,0,0,0,1,0
592,Vladimír Coufal,CZE,DF,West Ham,eng  Premier League,32-201,1992.0,8.2,14,9,9,4,1,6,15,40.0,9,11,10,1,6,20,29,1
593,Lassana Coulibaly,MLI,MF,Lecce,it  Serie A,28-335,1996.0,21.1,33,19,13,19,1,18,48,37.5,30,37,10,27,15,48,33,0
594,Lasso Coulibaly,GHA,"FW,MF",Auxerre,fr  Ligue 1,22-143,2002.0,0.4,0,0,0,0,0,0,0,,0,0,0,0,0,0,0,0
595,Mamadou Coulibaly,FRA,MF,Monaco,fr  Ligue 1,20-324,2004.0,0.1,1,0,0,1,0,0,0,,0,0,0,0,0,1,0,0
596,Soumaïla Coulibaly,FRA,DF,Brest,fr  Ligue 1,21-148,2003.0,4.9,4,2,2,2,0,1,1,100.0,0,7,2,5,5,9,26,0
597,Tanguy Coulibaly,FRA,"FW,MF",Montpellier,fr  Ligue 1,24-021,2001.0,8.2,13,9,2,8,3,3,10,30.0,7,7,0,7,5,18,1,0
598,Woyo Coulibaly,FRA,DF,Leicester City,eng  Premier League,25-295,1999.0,1.2,6,4,4,2,0,2,2,100.0,0,3,1,2,5,11,1,0
599,Woyo Coulibaly,FRA,DF,Parma,it  Serie A,25-295,1999.0,12.0,13,10,9,2,2,5,11,45.5,6,19,2,17,8,21,25,0
600,Marius Courcoul,FRA,"DF,MF",Angers,fr  Ligue 1,18-069,2007.0,0.4,1,0,1,0,0,0,1,0.0,1,1,0,1,0,1,1,0
601,Thibaut Courtois,BEL,GK,Real Madrid,es  La Liga,32-304,1992.0,23.0,0,0,0,0,0,0,0,,0,0,0,0,1,1,11,1
602,Yan Couto,BRA,DF,Dortmund,de  Bundesliga,22-281,2002.0,8.4,21,14,16,2,3,13,22,59.1,9,11,0,11,8,29,27,2
603,Nicolas Cozza,FRA,DF,Nantes,fr  Ligue 1,26-062,1999.0,16.5,38,27,21,13,4,18,30,60.0,12,18,6,12,17,55,48,0
604,Aaron Cresswell,ENG,DF,West Ham,eng  Premier League,35-086,1989.0,6.0,5,1,1,3,1,4,5,80.0,1,6,3,3,6,11,25,0
605,Charlie Cresswell,ENG,DF,Toulouse,fr  Ligue 1,22-206,2002.0,20.8,29,19,17,11,1,25,38,65.8,13,34,21,13,22,51,141,3
606,Bryan Cristante,ITA,MF,Roma,it  Serie A,30-008,1995.0,14.5,29,20,9,16,4,11,21,52.4,10,12,7,5,13,42,24,0
607,Domen Črnigoj,SVN,MF,Venezia,it  Serie A,29-113,1995.0,1.5,4,2,0,1,3,1,2,50.0,1,5,2,3,4,8,4,0
608,Juan Cruz Armada,ESP,DF,Osasuna,es  La Liga,32-226,1992.0,11.1,14,9,6,7,1,9,16,56.3,7,10,2,8,6,20,36,0
609,Juan Cruz,ESP,"FW,DF",Leganés,es  La Liga,24-320,2000.0,18.3,20,14,9,10,1,13,26,50.0,13,12,2,10,10,30,25,0
610,Juan Cuadrado,COL,"DF,MF",Atalanta,it  Serie A,36-289,1988.0,6.8,15,8,9,2,4,9,20,45.0,11,10,2,8,5,20,8,0
611,Pau Cubarsí,ESP,DF,Barcelona,es  La Liga,18-048,2007.0,22.8,23,17,17,3,3,13,20,65.0,7,9,7,2,11,34,68,0
612,Cucho,COL,FW,Betis,es  La Liga,25-325,1999.0,3.4,2,1,0,1,1,1,4,25.0,3,2,1,1,2,4,0,0
613,Marc Cucurella,ESP,DF,Chelsea,eng  Premier League,26-232,1998.0,24.0,47,31,26,18,3,22,42,52.4,20,37,10,27,20,67,58,3
614,Jorge Cuenca,ESP,DF,Fulham,eng  Premier League,25-114,1999.0,1.9,2,2,2,0,0,2,5,40.0,3,2,2,0,2,4,18,0
615,Matheus Cunha,BRA,"MF,FW",Wolves,eng  Premier League,25-288,1999.0,23.8,32,18,16,13,3,11,34,32.4,23,17,1,16,16,48,22,0
616,Patrick Cutrone,ITA,FW,Como,it  Serie A,27-067,1998.0,18.9,12,9,0,7,5,5,10,50.0,5,10,0,10,3,15,7,0
617,Tomáš Čvančara,CZE,"FW,MF",Gladbach,de  Bundesliga,24-210,2000.0,5.4,2,1,1,1,0,2,4,50.0,2,6,3,3,1,3,13,0
618,Wylan Cyprien,FRA,MF,Parma,it  Serie A,30-042,1995.0,0.3,0,0,0,0,0,0,1,0.0,1,1,0,1,1,1,0,0
619,Danilo D'Ambrosio,ITA,DF,Monza,it  Serie A,36-183,1988.0,9.3,18,10,9,8,1,7,14,50.0,7,10,7,3,13,31,29,2
620,Lucas Da Cunha,FRA,MF,Como,it  Serie A,23-275,2001.0,19.7,29,15,13,10,6,12,24,50.0,12,7,0,7,12,41,21,1
621,Samuel Dahl,SWE,"DF,MF",Roma,it  Serie A,25-007,2000.0,0.5,2,2,0,2,0,1,2,50.0,1,2,0,2,0,2,0,0
622,Finn Dahmen,GER,GK,Augsburg,de  Bundesliga,26-349,1998.0,10.0,0,0,0,0,0,0,0,,0,0,0,0,0,0,4,0
623,Thomas Dähne,GER,GK,Holstein Kiel,de  Bundesliga,31-066,1994.0,1.0,0,0,0,0,0,0,0,,0,0,0,0,0,0,0,0
624,Mahmoud Dahoud,GER,MF,Eint Frankfurt,de  Bundesliga,29-069,1996.0,4.0,9,4,4,5,0,4,6,66.7,2,5,1,4,2,11,5,0
625,Patson Daka,ZAM,"FW,MF",Leicester City,eng  Premier League,26-153,1998.0,4.4,8,4,1,4,3,5,12,41.7,7,5,1,4,1,9,6,0
626,Ameen Al-Dakhil,BEL,DF,Stuttgart,de  Bundesliga,23-005,2002.0,3.3,6,6,4,2,0,4,4,100.0,0,6,3,3,7,13,24,1
627,Thijs Dallinga,NED,"FW,MF",Bologna,it  Serie A,24-220,2000.0,6.0,9,5,0,3,6,3,3,100.0,0,6,1,5,1,10,5,1
628,Diogo Dalot,POR,DF,Manchester Utd,eng  Premier League,25-358,1999.0,26.6,59,34,36,18,5,28,43,65.1,15,20,9,11,35,94,63,0
629,Mikkel Damsgaard,DEN,"MF,FW",Brentford,eng  Premier League,24-251,2000.0,23.7,64,37,24,20,20,23,59,39.0,36,31,2,29,21,85,27,2
630,Maat Daniel Caprini,ITA,FW,Fiorentina,it  Serie A,19-028,2006.0,0.1,0,0,0,0,0,0,0,,0,0,0,0,0,0,0,0
631,Flavius Daniliuc,AUT,DF,Hellas Verona,it  Serie A,23-318,2001.0,10.0,23,18,13,7,3,13,22,59.1,9,8,2,6,7,30,25,0
632,Danilo,BRA,MF,Nott'ham Forest,eng  Premier League,23-316,2001.0,1.9,2,1,1,1,0,1,3,33.3,2,1,1,0,1,3,2,0
633,Danilo,BRA,DF,Juventus,it  Serie A,33-239,1991.0,6.5,10,4,7,2,1,5,10,50.0,5,4,3,1,9,19,21,1
634,Arnaut Danjuma,NED,FW,Villarreal,es  La Liga,28-039,1997.0,2.2,2,1,0,1,1,0,1,0.0,1,1,0,1,0,2,0,0
635,Arnaut Danjuma,NED,"FW,MF",Girona,es  La Liga,28-039,1997.0,9.8,7,5,3,3,1,2,5,40.0,3,5,1,4,2,9,2,0
636,Jayden Danns,ENG,MF,Liverpool,eng  Premier League,19-054,2006.0,0.1,0,0,0,0,0,0,1,0.0,1,0,0,0,0,0,0,0
637,Kévin Danois,FRA,MF,Auxerre,fr  Ligue 1,20-256,2004.0,13.3,42,27,18,18,6,16,37,43.2,21,10,1,9,16,58,18,0
638,Kevin Danso,AUT,DF,Tottenham,eng  Premier League,26-173,1998.0,3.9,5,4,2,3,0,4,6,66.7,2,4,4,0,2,7,22,1
639,Kevin Danso,AUT,DF,Lens,fr  Ligue 1,26-173,1998.0,12.0,19,7,12,5,2,12,16,75.0,4,25,19,6,20,39,62,1
640,Dante,BRA,DF,Nice,fr  Ligue 1,41-144,1983.0,17.3,27,11,16,9,2,14,25,56.0,11,20,9,11,28,55,59,1
641,Pape Daouda Diongue,SEN,"MF,FW",Strasbourg,fr  Ligue 1,,,0.8,1,0,0,1,0,0,1,0.0,1,0,0,0,3,4,2,0
642,Mohammed Daramy,DEN,FW,Reims,fr  Ligue 1,23-063,2002.0,0.2,0,0,0,0,0,0,0,,0,0,0,0,0,0,1,0
643,Bence Dárdai,GER,MF,Wolfsburg,de  Bundesliga,19-046,2006.0,9.1,14,8,3,11,0,8,17,47.1,9,14,4,10,9,23,15,1
644,Sergi Darder,ESP,"MF,FW",Mallorca,es  La Liga,31-079,1993.0,19.9,31,20,12,13,6,11,30,36.7,19,15,1,14,10,41,16,1
645,Matteo Darmian,ITA,DF,Inter,it  Serie A,35-099,1989.0,13.0,22,12,10,9,3,12,21,57.1,9,12,5,7,3,25,27,0
646,Lukas Daschner,GER,"MF,FW",Bochum,de  Bundesliga,26-161,1998.0,4.6,4,2,1,2,1,2,9,22.2,7,5,0,5,0,4,5,0
647,Juan David Cabal,COL,DF,Juventus,it  Serie A,24-062,2001.0,5.1,10,4,7,3,0,8,12,66.7,4,2,0,2,2,12,14,1
648,Jonathan David,CAN,FW,Lille,fr  Ligue 1,25-056,2000.0,20.2,17,4,3,9,5,7,13,53.8,6,9,2,7,3,20,7,0
649,Alphonso Davies,CAN,DF,Bayern Munich,de  Bundesliga,24-129,2000.0,16.3,29,17,6,17,6,17,26,65.4,9,14,1,13,13,42,22,2
650,Ben Davies,WAL,DF,Tottenham,eng  Premier League,31-321,1993.0,7.0,5,4,1,4,0,3,8,37.5,5,14,9,5,7,12,41,0
651,Keinan Davis,ENG,FW,Udinese,it  Serie A,27-026,1998.0,7.8,7,3,1,3,3,2,3,66.7,1,2,1,1,1,8,4,0
652,Leif Davis,ENG,DF,Ipswich Town,eng  Premier League,25-058,2000.0,26.3,45,26,32,9,4,29,46,63.0,17,22,7,15,23,68,67,2
653,Zuriko Davitashvili,GEO,"FW,MF",Saint-Étienne,fr  Ligue 1,24-024,2001.0,22.5,17,10,5,7,5,11,39,28.2,28,17,0,17,12,29,8,0
654,Paweł Dawidowicz,POL,DF,Hellas Verona,it  Serie A,29-295,1995.0,14.3,31,15,15,14,2,15,22,68.2,7,13,4,9,16,47,53,2
655,Craig Dawson,ENG,DF,Wolves,eng  Premier League,34-309,1990.0,10.8,15,3,8,6,1,12,15,80.0,3,16,11,5,9,24,52,1
656,Kevin De Bruyne,BEL,MF,Manchester City,eng  Premier League,33-256,1991.0,12.2,11,5,4,4,3,3,14,21.4,11,6,0,6,5,16,9,1
657,Charles De Ketelaere,BEL,"MF,FW",Atalanta,it  Serie A,24-001,2001.0,18.5,11,8,2,7,2,4,12,33.3,8,9,3,6,2,13,8,0
658,Rodrigo De Paul,ARG,MF,Atlético Madrid,es  La Liga,30-291,1994.0,16.6,21,16,9,8,4,11,25,44.0,14,20,2,18,5,26,10,3
659,Théo De Percin,MTQ,GK,Auxerre,fr  Ligue 1,24-037,2001.0,2.0,0,0,0,0,0,0,1,0.0,1,0,0,0,0,0,3,0
660,Mattia De Sciglio,ITA,DF,Empoli,it  Serie A,32-142,1992.0,8.5,18,13,10,8,0,14,17,82.4,3,10,3,7,8,26,34,1
661,Lorenzo De Silvestri,ITA,DF,Bologna,it  Serie A,36-292,1988.0,8.5,10,6,6,1,3,6,13,46.2,7,8,2,6,7,17,24,0
662,Thibault De Smet,BEL,DF,Reims,fr  Ligue 1,26-279,1998.0,2.1,6,4,5,1,0,4,4,100.0,0,5,3,2,4,10,12,0
663,Koni De Winter,BEL,DF,Genoa,it  Serie A,22-272,2002.0,15.1,23,15,14,6,3,12,17,70.6,5,5,3,2,13,36,71,2
664,Amar Dedić,BIH,"DF,FW",Marseille,fr  Ligue 1,22-205,2002.0,1.6,1,1,1,0,0,0,3,0.0,3,0,0,0,0,1,5,0
665,Alessandro Deiola,ITA,MF,Cagliari,it  Serie A,29-222,1995.0,11.6,23,15,7,14,2,8,24,33.3,16,14,7,7,10,33,31,0
666,Romain Del Castillo,FRA,FW,Brest,fr  Ligue 1,28-347,1996.0,11.4,25,17,9,8,8,17,29,58.6,12,15,0,15,6,31,3,0
667,Enrico Del Prato,ITA,DF,Parma,it  Serie A,25-121,1999.0,22.7,24,13,18,5,1,15,20,75.0,5,49,28,21,18,42,101,1
668,Liam Delap,ENG,FW,Ipswich Town,eng  Premier League,22-031,2003.0,23.3,9,6,3,2,4,1,12,8.3,11,7,0,7,2,11,21,0
669,Fisayo Dele-Bashiru,NGA,"MF,FW",Lazio,it  Serie A,24-033,2001.0,7.9,8,5,3,2,3,2,5,40.0,3,9,1,8,4,12,4,0
670,Andy Delort,ALG,FW,Montpellier,fr  Ligue 1,33-153,1991.0,4.8,3,3,0,2,1,0,1,0.0,1,1,1,0,0,3,3,0
671,Olivier Deman,BEL,DF,Werder Bremen,de  Bundesliga,24-339,2000.0,0.7,6,3,2,4,0,2,7,28.6,5,3,1,2,3,9,4,0
672,Ali Dembélé,FRA,DF,Torino,it  Serie A,21-065,2004.0,1.4,4,2,3,1,0,3,3,100.0,0,1,1,0,0,4,4,1
673,Ousmane Dembélé,FRA,FW,Paris S-G,fr  Ligue 1,27-300,1997.0,15.5,10,4,0,6,4,4,11,36.4,7,3,0,3,9,19,2,1
674,Ermedin Demirović,BIH,FW,Stuttgart,de  Bundesliga,26-351,1998.0,14.4,9,5,1,3,5,1,6,16.7,5,11,1,10,3,12,9,0
675,Sepp van den Berg,NED,DF,Brentford,eng  Premier League,23-081,2001.0,19.5,28,17,17,7,4,12,21,57.1,9,40,27,13,14,42,91,2
676,Arthur Desmas,FRA,GK,Le Havre,fr  Ligue 1,30-338,1994.0,17.0,0,0,0,0,0,0,1,0.0,1,0,0,0,0,0,9,1
677,Justin Devenny,NIR,MF,Crystal Palace,eng  Premier League,21-151,2003.0,3.5,10,7,6,3,1,7,12,58.3,5,3,0,3,0,10,8,0
678,Kiernan Dewsbury-Hall,ENG,MF,Chelsea,eng  Premier League,26-186,1998.0,2.0,4,2,1,0,3,2,4,50.0,2,1,0,1,1,5,4,1
679,Michele Di Gregorio,ITA,GK,Juventus,it  Serie A,27-227,1997.0,23.0,0,0,0,0,0,0,0,,0,0,0,0,0,0,8,0
680,Giovanni Di Lorenzo,ITA,DF,Napoli,it  Serie A,31-219,1993.0,28.0,51,35,26,19,6,33,52,63.5,19,12,5,7,25,76,60,1
681,Boulaye Dia,SEN,"MF,FW",Lazio,it  Serie A,28-115,1996.0,17.2,20,8,5,10,5,6,15,40.0,9,7,0,7,5,25,9,1
682,Mouctar Diakhaby,GUI,DF,Valencia,es  La Liga,28-082,1996.0,0.8,1,1,1,0,0,0,0,,0,0,0,0,2,3,4,0
683,Mamadou Diakhon,FRA,"FW,MF",Reims,fr  Ligue 1,19-170,2005.0,6.3,12,8,4,3,5,9,16,56.3,7,2,1,1,2,14,2,0
684,Bafodé Diakité,FRA,DF,Lille,fr  Ligue 1,24-064,2001.0,24.0,23,13,14,7,2,15,23,65.2,8,25,14,11,20,43,64,5
685,Oumar Diakité,CIV,FW,Reims,fr  Ligue 1,21-081,2003.0,17.5,20,13,7,8,5,9,18,50.0,9,12,2,10,3,23,9,0
686,Amad Diallo,CIV,"FW,MF",Manchester Utd,eng  Premier League,22-243,2002.0,17.7,33,26,6,19,8,15,26,57.7,11,10,0,10,11,44,16,0
687,Assane Diao,ESP,"FW,MF",Como,it  Serie A,19-185,2005.0,9.0,18,13,7,6,5,9,18,50.0,9,6,1,5,3,21,10,0
688,Assane Diao,ESP,FW,Betis,es  La Liga,19-185,2005.0,3.1,5,3,1,3,1,4,9,44.4,5,3,0,3,0,5,3,0
689,Habib Diarra,SEN,"MF,FW",Strasbourg,fr  Ligue 1,21-067,2004.0,21.6,19,10,5,12,2,8,18,44.4,10,19,6,13,11,30,36,2
690,Moussa Diarra,MLI,DF,Alavés,es  La Liga,24-121,2000.0,17.6,29,17,15,12,2,14,24,58.3,10,11,3,8,21,50,33,1
691,Rúben Dias,POR,DF,Manchester City,eng  Premier League,27-301,1997.0,15.2,11,6,5,5,1,4,7,57.1,3,12,11,1,15,26,37,2
692,Krépin Diatta,SEN,DF,Monaco,fr  Ligue 1,26-014,1999.0,4.1,15,9,10,2,3,11,18,61.1,7,5,1,4,7,22,9,1
693,Kandet Diawara,GUI,FW,Le Havre,fr  Ligue 1,25-029,2000.0,0.0,0,0,0,0,0,0,0,,0,1,0,1,0,0,1,0
694,Mahamadou Diawara,FRA,MF,Le Havre,fr  Ligue 1,20-022,2005.0,4.6,15,10,9,5,1,5,8,62.5,3,10,4,6,10,25,10,1
695,Mahamadou Diawara,FRA,MF,Lyon,fr  Ligue 1,20-022,2005.0,0.2,1,0,0,1,0,1,3,33.3,2,2,0,2,0,1,0,0
696,Brahim Díaz,MAR,"FW,MF",Real Madrid,es  La Liga,25-220,1999.0,10.9,21,16,7,11,3,6,13,46.2,7,12,0,12,3,24,1,0
697,Luis Díaz,COL,FW,Liverpool,eng  Premier League,28-057,1997.0,20.6,26,17,8,13,5,11,31,35.5,20,14,0,14,6,32,7,1
698,Pedro Díaz,ESP,MF,Rayo Vallecano,es  La Liga,26-279,1998.0,6.3,14,9,5,8,1,8,22,36.4,14,9,0,9,5,19,3,1
699,Tyler Dibling,ENG,"FW,MF",Southampton,eng  Premier League,18-364,2006.0,16.1,25,15,6,16,3,10,18,55.6,8,17,5,12,7,32,9,0
700,Diego,ESP,"FW,MF",Leganés,es  La Liga,24-327,2000.0,7.4,0,0,0,0,0,0,2,0.0,2,2,1,1,1,1,7,0
701,Justin Diehl,GER,"FW,DF",Stuttgart,de  Bundesliga,20-104,2004.0,1.2,1,0,0,1,0,1,1,100.0,0,2,0,2,0,1,0,0
702,Bamba Dieng,SEN,"FW,MF",Angers,fr  Ligue 1,24-353,2000.0,5.4,4,1,1,2,1,0,2,0.0,2,2,0,2,0,4,3,0
703,Eric Dier,ENG,DF,Bayern Munich,de  Bundesliga,31-055,1994.0,7.3,13,7,6,6,1,9,13,69.2,4,9,3,6,10,23,26,0
704,Lucas Digne,FRA,DF,Aston Villa,eng  Premier League,31-234,1993.0,22.9,55,31,32,15,8,38,56,67.9,18,22,4,18,25,80,74,1
705,Kembo Diliwidi,FRA,DF,Lens,fr  Ligue 1,19-036,2006.0,0.0,0,0,0,0,0,0,0,,0,0,0,0,0,0,0,0
706,Federico Dimarco,ITA,"DF,FW",Inter,it  Serie A,27-121,1997.0,18.7,17,9,6,8,3,7,14,50.0,7,17,2,15,11,28,25,2
707,Stole Dimitrievski,MKD,GK,Valencia,es  La Liga,31-076,1993.0,4.0,0,0,0,0,0,0,0,,0,0,0,0,0,0,3,1
708,Junior Dina Ebimbe,FRA,"MF,FW",Eint Frankfurt,de  Bundesliga,24-110,2000.0,3.3,3,2,1,2,0,1,3,33.3,2,4,0,4,7,10,6,0
709,Eren Dinkçi,GER,"MF,FW",Freiburg,de  Bundesliga,23-088,2001.0,12.7,21,13,8,8,5,7,23,30.4,16,21,2,19,6,27,7,0
710,Sinaly Diomande,CIV,DF,Auxerre,fr  Ligue 1,23-336,2001.0,13.8,22,9,11,10,1,15,24,62.5,9,26,14,12,18,40,63,2
711,Lois Diony,FRA,FW,Angers,fr  Ligue 1,32-081,1992.0,0.2,0,0,0,0,0,0,0,,0,0,0,0,0,0,0,0
712,Issa Diop,FRA,DF,Fulham,eng  Premier League,28-061,1997.0,14.0,25,11,17,8,0,13,18,72.2,5,10,7,3,8,33,67,2
713,Sérigné Diop,SEN,FW,Brest,fr  Ligue 1,19-303,2005.0,0.0,0,0,0,0,0,0,0,,0,0,0,0,0,0,0,0
714,Sofiane Diop,FRA,"MF,FW",Nice,fr  Ligue 1,24-275,2000.0,9.7,22,15,15,3,4,9,21,42.9,12,17,2,15,14,36,7,1
715,Andy Diouf,FRA,MF,Lens,fr  Ligue 1,21-298,2003.0,18.4,32,22,9,18,5,13,30,43.3,17,21,1,20,10,42,14,2
716,Yehvann Diouf,FRA,GK,Reims,fr  Ligue 1,25-115,1999.0,25.0,2,1,2,0,0,1,3,33.3,2,0,0,0,0,2,11,2
717,Assane Dioussé,SEN,MF,Auxerre,fr  Ligue 1,27-172,1997.0,2.4,8,2,5,3,0,3,6,50.0,3,1,0,1,6,14,5,0
718,Axel Disasi,FRA,DF,Aston Villa,eng  Premier League,27-000,1998.0,4.0,4,2,3,1,0,0,2,0.0,2,3,1,2,5,9,16,0
719,Axel Disasi,FRA,DF,Chelsea,eng  Premier League,27-000,1998.0,4.0,7,4,5,1,1,6,11,54.5,5,4,1,3,2,9,11,1
720,Roman Dixon,ENG,DF,Everton,eng  Premier League,20-075,2004.0,1.0,5,5,3,2,0,4,4,100.0,0,1,0,1,1,6,3,0
721,Álvaro djaló,ESP,FW,Athletic Club,es  La Liga,25-207,1999.0,5.1,6,4,3,2,1,1,3,33.3,2,2,0,2,1,7,4,0
722,Djené,TOG,"DF,MF",Getafe,es  La Liga,33-070,1991.0,23.0,15,6,8,6,1,5,22,22.7,17,15,7,8,19,34,84,3
723,Nasser Djiga,BFA,DF,Wolves,eng  Premier League,22-116,2002.0,0.2,0,0,0,0,0,0,0,,0,0,0,0,2,2,2,1
724,Berat Djimsiti,ALB,DF,Atalanta,it  Serie A,32-020,1993.0,21.0,42,26,22,19,1,25,32,78.1,7,25,15,10,31,73,82,1
725,Marko Dmitrović,SRB,GK,Leganés,es  La Liga,33-046,1992.0,21.0,1,1,1,0,0,1,2,50.0,1,0,0,0,0,1,20,2
726,Ritsu Doan,JPN,FW,Freiburg,de  Bundesliga,26-268,1998.0,23.0,55,35,27,22,6,21,33,63.6,12,35,1,34,12,67,31,1
727,Dodô,BRA,DF,Fiorentina,it  Serie A,26-114,1998.0,26.7,38,25,22,10,6,23,41,56.1,18,21,5,16,29,67,49,2
728,Danilho Doekhi,NED,DF,Union Berlin,de  Bundesliga,26-254,1998.0,25.0,28,17,12,14,2,11,17,64.7,6,28,13,15,31,59,102,1
729,Matt Doherty,IRL,DF,Wolves,eng  Premier League,33-054,1992.0,16.9,30,17,21,9,0,11,17,64.7,6,21,12,9,18,48,65,2
730,Jeremy Doku,BEL,"FW,MF",Manchester City,eng  Premier League,22-288,2002.0,11.9,24,16,9,9,6,7,11,63.6,4,7,1,6,4,28,2,0
731,Marc Domenech,ESP,FW,Mallorca,es  La Liga,19-069,2006.0,1.3,0,0,0,0,0,0,2,0.0,2,2,0,2,0,0,0,0
732,Álex Domínguez,ESP,GK,Toulouse,fr  Ligue 1,26-224,1998.0,0.2,0,0,0,0,0,0,0,,0,0,0,0,0,0,0,0
733,Benjamín Domínguez,ARG,FW,Bologna,it  Serie A,21-173,2003.0,10.7,13,5,1,10,2,3,16,18.8,13,14,1,13,4,17,6,0
734,Carlos Dominguez,ESP,DF,Celta Vigo,es  La Liga,24-028,2001.0,8.2,16,10,11,5,0,11,15,73.3,4,8,6,2,7,23,42,0
735,Israel Domínguez,ESP,FW,Sevilla,es  La Liga,21-308,2003.0,0.2,0,0,0,0,0,0,0,,0,0,0,0,0,0,0,0
736,Nicolás Domínguez,ARG,"MF,FW",Nott'ham Forest,eng  Premier League,26-256,1998.0,14.8,62,32,29,24,9,24,52,46.2,28,28,9,19,23,85,31,1
737,Sergi Dominguez,ESP,DF,Barcelona,es  La Liga,19-344,2005.0,1.9,1,1,1,0,0,0,0,,0,0,0,0,3,4,7,0
738,Gianluigi Donnarumma,ITA,GK,Paris S-G,fr  Ligue 1,26-014,1999.0,18.2,1,1,1,0,0,1,1,100.0,0,0,0,0,0,1,10,0
739,Patrick Dorgu,DEN,DF,Manchester Utd,eng  Premier League,20-136,2004.0,2.5,9,6,4,5,0,7,7,100.0,0,4,0,4,1,10,8,1
740,Patrick Dorgu,DEN,"DF,FW",Lecce,it  Serie A,20-136,2004.0,20.4,45,27,21,19,5,23,45,51.1,22,24,6,18,18,63,42,2
741,Alfie Dorrington,ENG,DF,Tottenham,eng  Premier League,19-325,2005.0,0.2,0,0,0,0,0,0,0,,0,0,0,0,0,0,0,0
742,Niklas Dorsch,GER,MF,Augsburg,de  Bundesliga,27-055,1998.0,0.4,0,0,0,0,0,0,0,,0,1,0,1,0,0,0,0
743,Niklas Dorsch,GER,MF,Heidenheim,de  Bundesliga,27-055,1998.0,9.0,16,9,5,11,0,6,11,54.5,5,11,1,10,8,24,11,1
744,Alberto Dossena,ITA,DF,Como,it  Serie A,26-149,1998.0,20.1,32,19,22,8,2,15,27,55.6,12,22,11,11,22,54,88,1
745,Abdoulaye Doucouré,MLI,MF,Everton,eng  Premier League,32-069,1993.0,21.3,34,20,15,14,5,7,23,30.4,16,23,5,18,7,41,16,1
746,Cheick Doucouré,MLI,MF,Crystal Palace,eng  Premier League,25-062,2000.0,5.0,16,8,6,8,2,5,11,45.5,6,4,0,4,11,27,10,1
747,Désiré Doué,FRA,"FW,MF",Paris S-G,fr  Ligue 1,19-281,2005.0,13.4,29,18,8,15,6,16,31,51.6,15,14,0,14,9,38,6,0
748,Guela Doué,CIV,DF,Strasbourg,fr  Ligue 1,22-145,2002.0,23.2,49,35,31,10,8,31,41,75.6,10,21,5,16,28,77,115,1
749,Douglas,BRA,MF,Nantes,fr  Ligue 1,28-057,1997.0,18.1,47,27,20,21,6,17,33,51.5,16,37,9,28,19,66,30,0
750,Ismaël Doukouré,FRA,"MF,DF",Strasbourg,fr  Ligue 1,21-230,2003.0,20.8,28,14,13,13,2,11,18,61.1,7,24,11,13,21,49,82,3
751,Issa Doumbia,CIV,MF,Venezia,it  Serie A,21-146,2003.0,7.2,9,6,2,6,1,6,12,50.0,6,14,4,10,7,16,10,0
752,Kamory Doumbia,MLI,MF,Brest,fr  Ligue 1,22-021,2003.0,10.3,30,21,12,14,4,10,24,41.7,14,11,1,10,22,52,11,1
753,Amidou Doumbouya,FRA,DF,Nice,fr  Ligue 1,17-218,2007.0,0.5,1,1,0,0,1,1,1,100.0,0,3,1,2,1,2,1,0
754,Anastasios Douvikas,GRE,FW,Como,it  Serie A,25-221,1999.0,0.6,0,0,0,0,0,0,1,0.0,1,0,0,0,1,1,1,0
755,Anastasios Douvikas,GRE,FW,Celta Vigo,es  La Liga,25-221,1999.0,7.8,9,4,2,6,1,3,6,50.0,3,5,2,3,3,12,6,0
756,Artem Dovbyk,UKR,FW,Roma,it  Serie A,27-263,1997.0,20.3,4,2,0,1,3,0,2,0.0,2,7,3,4,1,5,8,0
757,Flynn Downes,ENG,MF,Southampton,eng  Premier League,26-050,1999.0,16.8,36,20,17,15,4,12,29,41.4,17,20,4,16,26,62,33,4
758,Tommy Doyle,ENG,MF,Wolves,eng  Premier League,23-145,2001.0,5.4,11,6,6,3,2,6,15,40.0,9,11,5,6,5,16,11,1
759,Radu Drăgușin,ROU,DF,Tottenham,eng  Premier League,23-036,2002.0,13.9,10,6,8,2,0,6,12,50.0,6,22,16,6,15,25,49,4
760,Patrick Drewes,GER,GK,Bochum,de  Bundesliga,32-035,1993.0,21.0,0,0,0,0,0,0,1,0.0,1,1,0,1,0,0,11,1
761,Tim Drexler,GER,DF,Hoffenheim,de  Bundesliga,20-005,2005.0,4.0,17,7,11,6,0,9,12,75.0,3,6,4,2,1,18,9,1
762,Domingos Duarte,POR,DF,Getafe,es  La Liga,30-001,1995.0,11.0,13,5,10,2,1,6,8,75.0,2,15,7,8,9,22,87,0
763,Martin Dúbravka,SVK,GK,Newcastle Utd,eng  Premier League,36-055,1989.0,10.0,0,0,0,0,0,0,0,,0,0,0,0,0,0,3,0
764,Marvin Ducksch,GER,FW,Werder Bremen,de  Bundesliga,31-004,1994.0,19.9,8,6,3,4,1,2,12,16.7,10,6,1,5,5,13,20,1
765,Ondrej Duda,SVK,MF,Hellas Verona,it  Serie A,30-096,1994.0,17.9,28,17,11,15,2,19,46,41.3,27,17,6,11,24,52,22,4
766,Duk,CPV,"MF,FW",Leganés,es  La Liga,25-023,2000.0,0.5,4,3,1,2,1,1,1,100.0,0,2,0,2,0,4,0,0
767,Denzel Dumfries,NED,"DF,FW",Inter,it  Serie A,28-327,1996.0,18.8,22,16,10,9,3,12,22,54.5,10,25,5,20,6,28,21,1
768,Alfred Duncan,GHA,MF,Venezia,it  Serie A,32-001,1993.0,9.6,17,8,4,11,2,5,14,35.7,9,5,2,3,8,25,7,0
769,Lewis Dunk,ENG,DF,Brighton,eng  Premier League,33-110,1991.0,17.4,15,8,7,6,2,9,14,64.3,5,20,14,6,10,25,57,0
770,Jáder Durán,COL,FW,Aston Villa,eng  Premier League,21-088,2003.0,7.1,8,7,1,2,5,1,4,25.0,3,5,0,5,0,8,13,0
771,Pablo Durán,ESP,"FW,MF",Celta Vigo,es  La Liga,23-290,2001.0,9.9,10,6,2,6,2,3,10,30.0,7,6,2,4,7,17,5,0
772,Julien Duranville,BEL,"FW,MF",Dortmund,de  Bundesliga,18-310,2006.0,2.9,3,0,0,3,0,1,1,100.0,0,1,0,1,0,3,3,0
773,Hugo Duro,ESP,FW,Valencia,es  La Liga,25-121,1999.0,18.8,12,7,4,7,1,4,11,36.4,7,11,2,9,10,22,8,0
774,Jean-Kevin Duverne,HAI,DF,Nantes,fr  Ligue 1,27-242,1997.0,6.0,21,12,13,4,4,15,27,55.6,12,10,3,7,8,29,23,0
775,Paulo Dybala,ARG,"FW,MF",Roma,it  Serie A,31-116,1993.0,15.6,17,7,3,9,5,8,18,44.4,10,12,1,11,2,19,2,0
776,Stefan Džodić,SRB,"DF,MF",Montpellier,fr  Ligue 1,19-361,2005.0,2.1,6,3,3,3,0,4,6,66.7,2,5,4,1,4,10,8,0
777,Adam Dźwigała,POL,"DF,MF",St. Pauli,de  Bundesliga,29-167,1995.0,2.1,14,7,11,2,1,6,9,66.7,3,2,1,1,0,14,15,0
778,Aron Dønnum,NOR,"DF,MF",Toulouse,fr  Ligue 1,26-325,1998.0,22.0,38,23,15,18,5,19,39,48.7,20,23,3,20,23,61,32,1
779,Enzo Ebosse,CMR,DF,Udinese,it  Serie A,26-000,1999.0,1.0,0,0,0,0,0,0,2,0.0,2,3,3,0,1,1,1,0
780,Ederson,BRA,GK,Manchester City,eng  Premier League,31-206,1993.0,19.0,0,0,0,0,0,0,2,0.0,2,0,0,0,1,1,7,2
781,Éderson,BRA,MF,Atalanta,it  Serie A,25-247,1999.0,24.9,41,25,15,23,3,18,27,66.7,9,25,5,20,32,73,24,1
782,Noah Edjouma,FRA,"MF,FW",Toulouse,fr  Ligue 1,19-158,2005.0,0.9,1,1,0,1,0,0,0,,0,1,1,0,2,3,2,0
783,George Edmundson,ENG,DF,Ipswich Town,eng  Premier League,27-192,1997.0,0.0,0,0,0,0,0,0,0,,0,0,0,0,0,0,0,0
784,Odsonne Édouard,FRA,"MF,FW",Crystal Palace,eng  Premier League,27-054,1998.0,1.3,1,0,0,1,0,0,2,0.0,2,1,0,1,0,1,1,0
785,Odsonne Édouard,FRA,FW,Leicester City,eng  Premier League,27-054,1998.0,0.3,1,1,1,0,0,0,0,,0,0,0,0,0,1,1,0
786,Samuel Edozie,ENG,"DF,FW",Southampton,eng  Premier League,22-042,2003.0,0.7,3,1,0,1,2,2,2,100.0,0,0,0,0,0,3,0,0
787,Ronnie Edwards,ENG,DF,Southampton,eng  Premier League,21-348,2003.0,0.1,0,0,0,0,0,0,0,,0,1,1,0,0,0,0,0
788,Johannes Eggestein,GER,FW,St. Pauli,de  Bundesliga,26-307,1998.0,20.0,5,3,0,2,3,1,5,20.0,4,4,0,4,0,5,8,0
789,Maximilian Eggestein,GER,MF,Freiburg,de  Bundesliga,28-093,1996.0,22.8,39,21,14,19,6,18,33,54.5,15,23,4,19,25,64,36,1
790,Kingsley Ehizibue,NED,DF,Udinese,it  Serie A,29-290,1995.0,20.8,42,27,24,15,3,23,34,67.6,11,30,8,22,18,60,53,5
791,Chidera Ejuke,NGA,FW,Sevilla,es  La Liga,27-068,1998.0,8.2,11,8,3,6,2,6,14,42.9,8,9,0,9,2,13,2,0
792,Jeff Ekhator,ITA,"FW,MF",Genoa,it  Serie A,18-120,2006.0,7.1,4,2,2,1,1,3,6,50.0,3,8,1,7,1,5,4,0
793,Hugo Ekitike,FRA,FW,Eint Frankfurt,de  Bundesliga,22-264,2002.0,19.9,13,10,3,5,5,4,10,40.0,6,9,1,8,7,20,16,0
794,Jurgen Ekkelenkamp,NED,MF,Udinese,it  Serie A,24-340,2000.0,14.6,30,20,9,19,2,15,26,57.7,11,21,4,17,9,39,18,0
795,Jacques Ekomie,GAB,DF,Angers,fr  Ligue 1,21-204,2003.0,3.8,12,9,6,5,1,4,7,57.1,3,9,1,8,3,15,11,0
796,Emmanuel Ekong,SWE,"MF,FW",Empoli,it  Serie A,22-259,2002.0,2.1,4,3,0,2,2,3,3,100.0,0,2,1,1,1,5,1,0
797,Caleb Ekuban,GHA,FW,Genoa,it  Serie A,30-353,1994.0,4.9,3,3,1,1,1,1,1,100.0,0,3,0,3,1,4,4,0
798,Pierre Ekwah Elimby,FRA,MF,Saint-Étienne,fr  Ligue 1,23-055,2002.0,19.6,37,22,15,19,3,24,39,61.5,15,16,9,7,33,70,61,1
799,Anthony Elanga,SWE,"FW,MF",Nott'ham Forest,eng  Premier League,22-318,2002.0,19.8,15,10,7,6,2,4,14,28.6,10,7,1,6,5,20,23,0
800,Meschak Elia,COD,"FW,DF",Nantes,fr  Ligue 1,27-217,1997.0,0.9,4,3,2,1,1,0,0,,0,1,0,1,0,4,1,0
801,Mikael Ellertsson,ISL,"DF,MF",Venezia,it  Serie A,23-000,2002.0,20.8,45,21,27,11,7,26,47,55.3,21,28,4,24,12,57,54,0
802,Harvey Elliott,ENG,"MF,FW",Liverpool,eng  Premier League,21-341,2003.0,1.4,3,2,2,1,0,0,3,0.0,3,3,1,2,0,3,1,0
803,Elif Elmas,MKD,FW,Torino,it  Serie A,25-168,1999.0,2.7,1,1,0,1,0,0,1,0.0,1,4,1,3,3,4,1,0
804,Elif Elmas,MKD,MF,RB Leipzig,de  Bundesliga,25-168,1999.0,0.5,3,1,3,0,0,1,3,33.3,2,2,0,2,0,3,2,0
805,Aritz Elustondo,ESP,DF,Real Sociedad,es  La Liga,30-348,1994.0,7.9,12,7,7,3,2,7,11,63.6,4,10,8,2,4,16,33,0
806,Nico Elvedi,SUI,DF,Gladbach,de  Bundesliga,28-162,1996.0,17.5,27,16,18,5,4,13,17,76.5,4,23,19,4,23,50,99,0
807,Adri Embarba,ESP,"FW,MF",Rayo Vallecano,es  La Liga,32-308,1992.0,14.7,30,12,11,15,4,14,36,38.9,22,16,1,15,11,41,10,1
808,Breel Embolo,SUI,"FW,MF",Monaco,fr  Ligue 1,28-025,1997.0,13.6,13,9,4,3,6,3,12,25.0,9,5,0,5,2,15,4,1
809,Emanuel Emegha,NED,FW,Strasbourg,fr  Ligue 1,22-036,2003.0,18.6,5,5,1,2,2,1,3,33.3,2,12,5,7,1,6,23,0
810,Emerson,BRA,DF,Milan,it  Serie A,26-056,1999.0,15.3,45,28,24,16,5,16,34,47.1,18,13,2,11,14,59,56,0
811,Yunus Emre Konak,TUR,"MF,FW",Brentford,eng  Premier League,19-060,2006.0,0.3,3,3,0,3,0,1,2,50.0,1,0,0,0,0,3,0,0
812,Julio Enciso,PAR,"MF,FW",Ipswich Town,eng  Premier League,21-047,2004.0,2.1,4,2,1,1,2,1,1,100.0,0,1,0,1,1,5,0,0
813,Julio Enciso,PAR,"MF,FW",Brighton,eng  Premier League,21-047,2004.0,3.3,0,0,0,0,0,0,2,0.0,2,2,0,2,0,0,1,0
814,Wataru Endo,JPN,MF,Liverpool,eng  Premier League,32-030,1993.0,1.6,8,6,4,4,0,5,8,62.5,3,3,0,3,3,11,5,0
815,Endrick,BRA,FW,Real Madrid,es  La Liga,18-233,2006.0,1.3,1,1,1,0,0,1,3,33.3,2,0,0,0,3,4,0,0
816,Yannik Engelhardt,GER,"MF,DF",Como,it  Serie A,24-032,2001.0,11.9,27,10,11,13,3,15,24,62.5,9,10,5,5,10,37,25,0
817,Arne Engels,BEL,"MF,FW",Augsburg,de  Bundesliga,21-184,2003.0,0.9,0,0,0,0,0,0,0,,0,1,1,0,0,0,0,0
818,Christian Eriksen,DEN,MF,Manchester Utd,eng  Premier League,33-025,1992.0,7.9,13,5,3,8,2,7,14,50.0,7,9,4,5,7,20,6,0
819,Martin Erlic,CRO,DF,Bologna,it  Serie A,27-046,1998.0,3.2,2,0,0,2,0,1,2,50.0,1,5,4,1,2,4,6,0
820,Patrick Erras,GER,DF,Holstein Kiel,de  Bundesliga,30-049,1995.0,9.2,8,5,6,2,0,2,9,22.2,7,13,11,2,9,17,64,0
821,Alfonso Espino,URU,DF,Rayo Vallecano,es  La Liga,33-065,1992.0,5.3,27,15,20,5,2,16,29,55.2,13,11,4,7,10,37,14,0
822,Sebastiano Esposito,ITA,"FW,MF",Empoli,it  Serie A,22-252,2002.0,17.9,38,21,12,19,7,12,26,46.2,14,16,2,14,11,49,8,0
823,Romain Esse,ENG,MF,Crystal Palace,eng  Premier League,19-302,2005.0,0.1,1,1,1,0,0,1,1,100.0,0,0,0,0,0,1,0,0
824,Samuel Essende,COD,FW,Augsburg,de  Bundesliga,27-047,1998.0,13.8,4,4,0,2,2,2,3,66.7,1,10,1,9,0,4,6,0
825,Dario Essugo,POR,MF,Las Palmas,es  La Liga,19-362,2005.0,14.6,43,33,23,15,5,23,37,62.2,14,15,8,7,28,71,33,7
826,Nahuel Estévez,ARG,MF,Parma,it  Serie A,29-117,1995.0,6.0,12,4,6,5,1,4,12,33.3,8,7,2,5,3,15,20,0
827,Pervis Estupiñán,ECU,DF,Brighton,eng  Premier League,27-049,1998.0,17.8,42,29,21,15,6,20,31,64.5,11,10,2,8,21,63,41,0
828,Etienne Eto'o,CMR,FW,Rayo Vallecano,es  La Liga,22-205,2002.0,0.0,0,0,0,0,0,0,0,,0,0,0,0,0,0,0,0
829,Evanilson,BRA,FW,Bournemouth,eng  Premier League,25-156,1999.0,16.2,10,5,3,4,3,4,8,50.0,4,7,1,6,0,10,11,0
830,Jonny Evans,NIR,DF,Manchester Utd,eng  Premier League,37-067,1988.0,3.2,7,5,4,3,0,2,4,50.0,2,2,1,1,4,11,13,0
831,Edu Expósito,ESP,"MF,FW",Espanyol,es  La Liga,28-222,1996.0,1.7,5,2,2,3,0,4,10,40.0,6,0,0,0,2,7,3,1
832,Eberechi Eze,ENG,"MF,FW",Crystal Palace,eng  Premier League,26-255,1998.0,21.4,35,21,12,14,9,16,33,48.5,17,24,0,24,9,44,8,3
833,Abde Ezzalzouli,MAR,"FW,MF",Betis,es  La Liga,23-084,2001.0,17.2,31,21,13,15,3,11,20,55.0,9,17,3,14,5,36,11,0
834,Giovanni Fabbian,ITA,MF,Bologna,it  Serie A,22-056,2003.0,9.3,10,6,1,3,6,7,12,58.3,5,4,1,3,2,12,4,0
835,Łukasz Fabiański,POL,GK,West Ham,eng  Premier League,39-327,1985.0,11.9,0,0,0,0,0,0,1,0.0,1,0,0,0,0,0,5,1
836,Alieu Fadera,GAM,"FW,DF",Como,it  Serie A,23-128,2001.0,17.7,60,45,24,24,12,20,44,45.5,24,17,1,16,10,70,9,0
837,Wout Faes,BEL,DF,Leicester City,eng  Premier League,26-342,1998.0,22.3,31,20,19,10,2,15,33,45.5,18,39,27,12,19,50,132,3
838,Nicolò Fagioli,ITA,MF,Fiorentina,it  Serie A,24-027,2001.0,2.8,8,4,3,4,1,5,10,50.0,5,1,0,1,0,8,5,2
839,Nicolò Fagioli,ITA,MF,Juventus,it  Serie A,24-027,2001.0,6.3,14,10,7,6,1,6,9,66.7,3,4,0,4,2,16,5,0
840,Romain Faivre,FRA,"MF,FW",Brest,fr  Ligue 1,26-240,1998.0,9.1,13,10,4,5,4,5,10,50.0,5,7,0,7,4,17,3,1
841,Wladimiro Falcone,ITA,GK,Lecce,it  Serie A,29-333,1995.0,28.0,0,0,0,0,0,0,0,,0,0,0,0,0,0,23,1
842,Davide Faraoni,ITA,DF,Hellas Verona,it  Serie A,33-137,1991.0,2.9,10,9,5,5,0,3,9,33.3,6,7,3,4,2,12,12,1
843,Abdul Fatawu Issahaku,GHA,FW,Leicester City,eng  Premier League,21-003,2004.0,6.4,21,15,13,2,6,11,19,57.9,8,7,0,7,4,25,12,0
844,Ansu Fati,ESP,FW,Barcelona,es  La Liga,22-131,2002.0,1.4,1,1,0,1,0,0,0,,0,0,0,0,0,1,0,1
845,Khalil Fayad,FRA,"MF,FW",Montpellier,fr  Ligue 1,20-275,2004.0,7.2,26,13,11,14,1,12,21,57.1,9,11,1,10,7,33,14,1
846,Jacopo Fazzini,ITA,"MF,FW",Empoli,it  Serie A,21-360,2003.0,8.5,21,11,9,10,2,10,17,58.8,7,8,1,7,5,26,15,0
847,Peter Federico,DOM,"MF,FW",Getafe,es  La Liga,22-229,2002.0,3.7,7,4,1,3,3,4,6,66.7,2,6,0,6,1,8,4,0
848,Nabil Fekir,FRA,MF,Betis,es  La Liga,31-236,1993.0,2.0,3,2,1,1,1,1,2,50.0,1,2,0,2,0,3,0,0
849,Mattia Felici,ITA,"MF,FW",Cagliari,it  Serie A,23-328,2001.0,9.1,16,12,8,6,2,4,9,44.4,5,9,0,9,6,22,7,0
850,Luiz Felipe,ITA,DF,Marseille,fr  Ligue 1,27-354,1997.0,0.1,0,0,0,0,0,0,0,,0,0,0,0,1,1,0,0
851,João Félix,POR,"FW,MF",Chelsea,eng  Premier League,25-121,1999.0,4.1,8,3,2,5,1,5,9,55.6,4,2,0,2,3,11,2,0
852,João Félix,POR,MF,Milan,it  Serie A,25-121,1999.0,4.2,1,1,1,0,0,1,6,16.7,5,1,0,1,0,1,5,0
853,Kiko Femenía,ESP,DF,Villarreal,es  La Liga,34-037,1991.0,19.2,37,25,26,10,1,23,42,54.8,19,15,8,7,30,67,41,2
854,Evan Ferguson,IRL,FW,West Ham,eng  Premier League,20-143,2004.0,1.0,1,0,0,0,1,0,0,,0,2,1,1,1,2,1,0
855,Evan Ferguson,IRL,FW,Brighton,eng  Premier League,20-143,2004.0,2.7,4,3,0,3,1,2,5,40.0,3,3,1,2,0,4,4,0
856,Lewis Ferguson,SCO,MF,Bologna,it  Serie A,25-199,1999.0,5.9,13,7,2,7,4,5,10,50.0,5,5,1,4,2,15,9,0
857,Zinedine Ferhat,ALG,FW,Angers,fr  Ligue 1,32-010,1993.0,6.6,5,3,0,3,2,2,8,25.0,6,8,0,8,6,11,9,0
858,Bruno Fernandes,POR,MF,Manchester Utd,eng  Premier League,30-184,1994.0,25.4,61,36,17,32,12,25,63,39.7,38,24,4,20,20,81,28,2
859,Edimilson Fernandes,SUI,MF,Brest,fr  Ligue 1,28-330,1996.0,8.9,8,6,2,6,0,6,10,60.0,4,11,4,7,17,25,24,1
860,Mateus Fernandes,POR,MF,Southampton,eng  Premier League,20-244,2004.0,23.3,66,38,35,20,11,23,50,46.0,27,31,3,28,16,82,24,5
861,Álvaro Fernández,ESP,GK,Sevilla,es  La Liga,26-332,1998.0,7.3,0,0,0,0,0,0,1,0.0,1,0,0,0,0,0,7,0
862,Enzo Fernández,ARG,MF,Chelsea,eng  Premier League,24-053,2001.0,22.8,53,26,12,26,15,26,64,40.6,38,27,4,23,10,63,17,4
863,Roberto Férnandez,ESP,FW,Espanyol,es  La Liga,22-251,2002.0,5.5,4,4,2,1,1,0,0,,0,3,1,2,2,6,7,0
864,Valery Fernández,ESP,"MF,FW",Mallorca,es  La Liga,25-108,1999.0,2.6,8,7,3,2,3,5,7,71.4,2,2,1,1,0,8,1,0
865,Matias Fernandez-Pardo,BEL,FW,Lille,fr  Ligue 1,20-036,2005.0,5.2,6,4,3,3,0,4,8,50.0,4,5,0,5,1,7,4,0
866,Jordan Ferri,FRA,MF,Montpellier,fr  Ligue 1,32-364,1992.0,12.6,28,13,13,14,1,11,23,47.8,12,10,1,9,8,36,13,0
867,Daniel Fila,CZE,FW,Venezia,it  Serie A,22-202,2002.0,1.7,1,0,0,0,1,0,1,0.0,1,3,0,3,0,1,1,0
868,Karol Fila,POL,MF,Strasbourg,fr  Ligue 1,26-271,1998.0,0.1,0,0,0,0,0,0,0,,0,0,0,0,0,0,0,0
869,Kilian Fischer,GER,DF,Wolfsburg,de  Bundesliga,24-150,2000.0,18.2,46,30,36,6,4,34,66,51.5,32,32,5,27,14,60,69,2
870,Mark Flekken,NED,GK,Brentford,eng  Premier League,31-271,1993.0,26.4,3,3,3,0,0,2,7,28.6,5,1,0,1,0,3,21,3
871,Mateo Flores,ESP,MF,Betis,es  La Liga,20-338,2004.0,1.7,3,1,3,0,0,1,1,100.0,0,1,0,1,2,5,3,0
872,Phil Foden,ENG,"MF,FW",Manchester City,eng  Premier League,24-287,2000.0,17.9,12,5,5,4,3,7,17,41.2,10,11,1,10,9,21,7,1
873,Malick Fofana,BEL,FW,Lyon,fr  Ligue 1,19-345,2005.0,13.2,16,8,7,8,1,7,14,50.0,7,10,0,10,8,24,6,0
874,Rayan Fofana,FRA,"FW,MF",Lens,fr  Ligue 1,19-027,2006.0,0.3,2,2,1,1,0,0,0,,0,0,0,0,0,2,0,0
875,Seko Fofana,CIV,MF,Rennes,fr  Ligue 1,29-308,1995.0,4.9,7,4,2,5,0,0,2,0.0,2,4,1,3,5,12,3,0
876,Wesley Fofana,FRA,DF,Chelsea,eng  Premier League,24-084,2000.0,12.1,13,12,6,7,0,6,14,42.9,8,14,9,5,13,26,51,2
877,Yahia Fofana,CIV,GK,Angers,fr  Ligue 1,24-202,2000.0,25.0,0,0,0,0,0,0,2,0.0,2,0,0,0,1,1,19,2
878,Youssouf Fofana,FRA,MF,Milan,it  Serie A,26-060,1999.0,21.8,42,27,12,27,3,20,39,51.3,19,20,4,16,17,59,20,2
879,Jonas Föhrenbach,GER,DF,Heidenheim,de  Bundesliga,29-044,1996.0,19.6,43,23,23,15,5,22,35,62.9,13,26,3,23,16,59,57,0
880,Michael Folorunsho,ITA,"FW,MF",Fiorentina,it  Serie A,27-032,1998.0,5.4,12,9,3,5,4,5,14,35.7,9,6,1,5,3,15,6,0
881,Michael Folorunsho,ITA,"FW,MF",Napoli,it  Serie A,27-032,1998.0,0.4,3,2,0,3,0,2,4,50.0,2,0,0,0,1,4,1,1
882,Lamine Fomba,FRA,MF,Saint-Étienne,fr  Ligue 1,27-044,1998.0,2.4,8,6,2,5,1,2,7,28.6,5,7,1,6,4,12,5,1
883,Carlos Forbs,POR,"MF,FW",Wolves,eng  Premier League,20-357,2004.0,2.6,8,5,5,2,1,4,5,80.0,1,3,0,3,1,9,2,1
884,Pablo Fornals,ESP,"MF,FW",Betis,es  La Liga,29-017,1996.0,12.3,13,9,6,6,1,5,17,29.4,12,18,0,18,14,27,10,1
885,Omari Forson,ENG,"MF,FW",Monza,it  Serie A,20-234,2004.0,0.8,2,2,1,1,0,1,2,50.0,1,2,0,2,0,2,0,0
886,Fraser Forster,ENG,GK,Tottenham,eng  Premier League,36-359,1988.0,7.0,0,0,0,0,0,0,1,0.0,1,0,0,0,0,0,7,3
887,Héctor Fort,ESP,DF,Barcelona,es  La Liga,18-221,2006.0,4.2,9,6,4,3,2,8,11,72.7,3,9,0,9,6,15,10,0
888,Dimitri Foulquier,FRA,DF,Valencia,es  La Liga,31-353,1993.0,18.9,33,23,21,9,3,18,29,62.1,11,15,3,12,11,44,56,1
889,Juan Foyth,ARG,DF,Villarreal,es  La Liga,27-058,1998.0,7.0,12,8,7,4,1,5,8,62.5,3,10,3,7,10,22,48,1
890,Alejandro Francés,ESP,DF,Girona,es  La Liga,22-222,2002.0,7.9,22,15,13,8,1,18,25,72.0,7,9,3,6,12,34,26,0
891,Przemysław Frankowski,POL,DF,Lens,fr  Ligue 1,29-333,1995.0,15.4,32,21,17,10,5,19,30,63.3,11,10,2,8,19,51,28,0
892,Enric Franquesa,ESP,"DF,FW",Leganés,es  La Liga,28-013,1997.0,6.8,17,9,9,6,2,9,13,69.2,4,7,1,6,5,22,12,0
893,Ryan Fraser,SCO,"FW,DF",Southampton,eng  Premier League,31-015,1994.0,3.4,6,2,2,4,0,4,6,66.7,2,1,1,0,1,7,9,0
894,Davide Frattesi,ITA,MF,Inter,it  Serie A,25-140,1999.0,9.3,11,6,4,6,1,6,13,46.2,7,8,2,6,3,14,5,1
895,Morten Frendrup,DEN,MF,Genoa,it  Serie A,23-338,2001.0,26.5,89,56,19,45,25,29,63,46.0,34,49,15,34,35,124,49,0
896,Martin Frese,DEN,DF,Hellas Verona,it  Serie A,27-066,1998.0,3.7,13,7,6,7,0,5,8,62.5,3,2,1,1,6,19,14,1
897,Remo Freuler,SUI,MF,Bologna,it  Serie A,32-330,1992.0,26.6,61,28,23,30,8,27,61,44.3,34,29,2,27,28,89,48,1
898,Marco Friedl,AUT,DF,Werder Bremen,de  Bundesliga,26-360,1998.0,15.9,45,31,24,20,1,28,51,54.9,23,27,15,12,29,74,87,0
899,Marvin Friedrich,GER,DF,Gladbach,de  Bundesliga,29-088,1995.0,10.5,14,8,11,3,0,8,14,57.1,6,16,12,4,5,19,51,0
900,Jeremie Frimpong,NED,"DF,MF",Leverkusen,de  Bundesliga,24-091,2000.0,18.8,26,19,9,10,7,11,22,50.0,11,21,0,21,7,33,14,0
901,Jorge de Frutos,ESP,"FW,MF",Rayo Vallecano,es  La Liga,28-019,1997.0,19.5,25,13,9,9,7,10,31,32.3,21,16,0,16,14,39,17,1
902,Darío Fuentes,ESP,DF,Sevilla,es  La Liga,22-058,2003.0,0.1,0,0,0,0,0,0,0,,0,0,0,0,0,0,0,0
903,Chris Führich,GER,"MF,FW",Stuttgart,de  Bundesliga,27-061,1998.0,15.7,11,6,2,4,5,10,22,45.5,12,20,2,18,5,16,14,0
904,Shiō Fukuda,JPN,"FW,MF",Gladbach,de  Bundesliga,20-337,2004.0,0.5,0,0,0,0,0,0,0,,0,1,0,1,0,0,0,0
905,Angelo Fulgini,FRA,"MF,FW",Lens,fr  Ligue 1,28-203,1996.0,10.3,13,9,6,4,3,6,16,37.5,10,11,1,10,2,15,3,0
906,Niclas Füllkrug,GER,FW,West Ham,eng  Premier League,32-030,1993.0,4.1,2,2,0,1,1,2,3,66.7,1,0,0,0,0,2,5,0
907,Kyogo Furuhashi,JPN,FW,Rennes,fr  Ligue 1,30-050,1995.0,1.0,1,1,1,0,0,0,0,,0,0,0,0,0,1,0,0
908,Manuel Fuster,ESP,"FW,MF",Las Palmas,es  La Liga,27-140,1997.0,7.6,13,7,2,7,4,12,20,60.0,8,9,1,8,2,15,11,0
909,Matteo Gabbia,ITA,DF,Milan,it  Serie A,25-141,1999.0,15.0,11,6,6,4,1,6,7,85.7,1,15,12,3,11,22,58,1
910,Alessandro Gabrielloni,ITA,"FW,MF",Como,it  Serie A,30-244,1994.0,1.2,0,0,0,0,0,0,3,0.0,3,0,0,0,0,0,0,0
911,Gianluca Gaetano,ITA,"MF,FW",Cagliari,it  Serie A,24-310,2000.0,9.1,9,6,3,5,1,4,13,30.8,9,7,0,7,5,14,7,0
912,Roberto Gagliardini,ITA,"MF,DF",Monza,it  Serie A,30-338,1994.0,1.1,1,0,0,1,0,0,2,0.0,2,0,0,0,1,2,4,0
913,Cody Gakpo,NED,FW,Liverpool,eng  Premier League,25-308,1999.0,15.7,23,12,5,10,8,11,20,55.0,9,17,2,15,7,30,15,1
914,Javi Galán,ESP,DF,Atlético Madrid,es  La Liga,30-112,1994.0,13.2,38,23,25,10,3,19,38,50.0,19,11,3,8,7,45,30,0
915,Iñigo Ruiz de Galarreta,ESP,MF,Athletic Club,es  La Liga,31-217,1993.0,11.6,27,20,10,12,5,14,22,63.6,8,6,2,4,10,37,8,2
916,Conor Gallagher,ENG,MF,Atlético Madrid,es  La Liga,25-033,2000.0,12.1,30,22,9,14,7,14,32,43.8,18,16,4,12,13,43,19,0
917,Antonino Gallo,ITA,DF,Lecce,it  Serie A,25-065,2000.0,19.5,42,29,28,10,4,20,39,51.3,19,17,1,16,15,57,77,0
918,Gauthier Gallon,FRA,GK,Rennes,fr  Ligue 1,31-322,1993.0,0.5,0,0,0,0,0,0,0,,0,0,0,0,0,0,0,0
919,Cristian Gamboa,CRC,DF,Bochum,de  Bundesliga,35-138,1989.0,1.7,6,2,5,1,0,3,9,33.3,6,0,0,0,0,6,5,0
920,Idrissa Gana Gueye,SEN,MF,Everton,eng  Premier League,35-166,1989.0,24.2,106,65,51,42,13,47,75,62.7,28,36,5,31,33,139,22,0
921,Ignatius Ganago,CMR,"FW,MF",Nantes,fr  Ligue 1,26-023,1999.0,2.7,1,1,0,1,0,1,2,50.0,1,3,1,2,4,5,2,0
922,Silvère Ganvoula M'Boussy,CGO,FW,Monza,it  Serie A,28-262,1996.0,3.3,0,0,0,0,0,0,1,0.0,1,1,0,1,1,1,5,0
923,Facundo Garcés,ARG,DF,Alavés,es  La Liga,25-187,1999.0,0.4,0,0,0,0,0,0,0,,0,0,0,0,0,0,5,0
924,Aleix García,ESP,MF,Leverkusen,de  Bundesliga,27-256,1997.0,11.1,8,4,2,4,2,4,9,44.4,5,8,1,7,6,14,17,1
925,Álvaro García,ESP,"FW,MF",Rayo Vallecano,es  La Liga,32-135,1992.0,18.6,29,21,17,8,4,11,23,47.8,12,23,0,23,25,54,31,1
926,Andrés García,ESP,"DF,MF",Aston Villa,eng  Premier League,22-032,2003.0,3.0,7,5,5,2,0,3,6,50.0,3,2,0,2,0,7,8,2
927,Eric García,ESP,"MF,DF",Barcelona,es  La Liga,24-061,2001.0,9.1,19,11,4,13,2,8,10,80.0,2,14,6,8,8,27,21,0
928,Fran Garcia,ESP,DF,Real Madrid,es  La Liga,25-209,1999.0,14.6,24,17,14,6,4,7,21,33.3,14,13,3,10,19,43,41,0
929,Joan García,ESP,GK,Espanyol,es  La Liga,23-311,2001.0,26.0,0,0,0,0,0,0,1,0.0,1,1,0,1,0,0,14,4
930,Pablo Garcia,ESP,FW,Betis,es  La Liga,18-208,2006.0,0.3,0,0,0,0,0,0,0,,0,1,0,1,0,0,0,0
931,Rubén García,ESP,"FW,MF",Osasuna,es  La Liga,31-240,1993.0,18.1,37,25,14,14,9,19,43,44.2,24,25,1,24,12,49,28,1
932,Ulisses Garcia,SUI,DF,Marseille,fr  Ligue 1,29-059,1996.0,5.6,10,8,4,4,2,3,10,30.0,7,3,0,3,4,14,9,0
933,Alejandro Garnacho,ARG,"FW,MF",Manchester Utd,eng  Premier League,20-253,2004.0,17.5,20,13,9,4,7,6,20,30.0,14,16,0,16,10,30,10,2
934,James Garner,ENG,"MF,DF",Everton,eng  Premier League,23-363,2001.0,8.7,22,13,13,7,2,12,25,48.0,13,9,3,6,8,30,24,0
935,Yarek Gasiorowski,ESP,DF,Valencia,es  La Liga,20-058,2005.0,10.4,19,16,16,3,0,9,13,69.2,4,17,6,11,25,44,54,0
936,Federico Gatti,ITA,DF,Juventus,it  Serie A,26-260,1998.0,23.8,28,23,18,8,2,14,24,58.3,10,26,18,8,17,45,72,2
937,Gavi,ESP,MF,Barcelona,es  La Liga,20-218,2004.0,4.9,11,7,3,7,1,7,9,77.8,2,7,1,6,7,18,4,0
938,Paulo Gazzaniga,ARG,GK,Girona,es  La Liga,33-068,1992.0,26.5,1,1,1,0,0,1,1,100.0,0,1,0,1,0,1,9,3
939,Jean-Philippe Gbamin,CIV,MF,Nantes,fr  Ligue 1,29-167,1995.0,2.4,2,1,0,2,0,1,4,25.0,3,5,2,3,3,5,2,0
940,Mory Gbane,CIV,"DF,MF",Reims,fr  Ligue 1,24-076,2000.0,4.5,11,6,8,3,0,7,11,63.6,4,4,4,0,9,20,30,1
941,Yann Gboho,FRA,"MF,FW",Toulouse,fr  Ligue 1,24-056,2001.0,18.5,23,10,6,9,8,11,23,47.8,12,16,0,16,4,27,4,0
942,David de Gea,ESP,GK,Fiorentina,it  Serie A,34-124,1990.0,25.0,0,0,0,0,0,0,0,,0,0,0,0,0,0,8,0
943,Viggo Gebel,GER,MF,RB Leipzig,de  Bundesliga,17-109,2007.0,0.2,0,0,0,0,0,0,0,,0,0,0,0,0,0,0,0
944,Lutsharel Geertruida,NED,DF,RB Leipzig,de  Bundesliga,24-236,2000.0,13.6,29,18,21,8,0,15,30,50.0,15,11,3,8,14,43,45,3
945,Dennis Geiger,GER,"MF,FW",Hoffenheim,de  Bundesliga,26-274,1998.0,5.6,14,9,6,7,1,6,10,60.0,4,10,2,8,2,16,5,0
946,Valentin Gendrey,FRA,DF,Lecce,it  Serie A,24-263,2000.0,2.0,2,2,1,0,1,1,1,100.0,0,3,1,2,2,4,1,0
947,Valentin Gendrey,FRA,DF,Hoffenheim,de  Bundesliga,24-263,2000.0,12.5,26,10,16,8,2,10,15,66.7,5,14,4,10,14,40,39,0
948,Denis Genreau,AUS,MF,Toulouse,fr  Ligue 1,25-294,1999.0,2.5,7,5,4,1,2,4,8,50.0,4,3,0,3,3,10,4,0
949,Tyrique George,ENG,FW,Chelsea,eng  Premier League,19-035,2006.0,0.8,2,0,2,0,0,2,3,66.7,1,0,0,0,1,3,0,0
950,Yannick Gerhardt,GER,"MF,DF",Wolfsburg,de  Bundesliga,30-363,1994.0,11.5,22,12,12,9,1,8,22,36.4,14,25,7,18,13,35,32,0
951,Max Geschwill,GER,DF,Holstein Kiel,de  Bundesliga,23-247,2001.0,13.5,26,21,13,12,1,14,19,73.7,5,14,9,5,27,53,47,0
952,Daniele Ghilardi,ITA,DF,Hellas Verona,it  Serie A,22-064,2003.0,13.6,24,15,16,8,0,14,29,48.3,15,17,11,6,15,39,63,0
953,Lautaro Gianetti,ARG,DF,Udinese,it  Serie A,31-118,1993.0,9.3,22,10,16,5,1,14,20,70.0,6,19,10,9,15,37,44,1
954,Dimitris Giannoulis,GRE,DF,Augsburg,de  Bundesliga,29-145,1995.0,20.8,38,27,23,12,3,20,35,57.1,15,35,8,27,29,67,53,0
955,Morgan Gibbs-White,ENG,MF,Nott'ham Forest,eng  Premier League,25-043,2000.0,21.4,32,15,12,15,5,12,21,57.1,9,11,4,7,14,46,19,1
956,Samuel Gigot,FRA,DF,Lazio,it  Serie A,31-150,1993.0,3.8,2,1,0,2,0,0,1,0.0,1,5,3,2,6,8,18,0
957,Armin Gigovic,BIH,MF,Holstein Kiel,de  Bundesliga,22-339,2002.0,15.1,19,9,11,5,3,3,17,17.6,14,15,1,14,16,35,25,0
958,Bryan Gil,ESP,"FW,MF",Girona,es  La Liga,24-028,2001.0,19.1,34,20,10,15,9,14,30,46.7,16,24,0,24,10,44,9,4
959,Mario Gila,ESP,DF,Lazio,it  Serie A,24-194,2000.0,23.2,42,30,26,14,2,29,42,69.0,13,18,13,5,21,63,78,2
960,Billy Gilmour,SCO,MF,Brighton,eng  Premier League,23-273,2001.0,1.1,3,3,2,1,0,3,4,75.0,1,1,0,1,0,3,1,0
961,Billy Gilmour,SCO,MF,Napoli,it  Serie A,23-273,2001.0,6.5,15,9,5,5,5,7,13,53.8,6,6,1,5,5,20,7,0
962,Benedikt Gimber,GER,DF,Heidenheim,de  Bundesliga,28-020,1997.0,21.7,60,39,44,16,0,31,47,66.0,16,44,17,27,25,85,102,1
963,Santiago Giménez,MEX,FW,Milan,it  Serie A,23-327,2001.0,4.9,3,3,0,2,1,2,2,100.0,0,3,1,2,1,4,9,0
964,Gvidas Gineitis,LTU,MF,Torino,it  Serie A,20-330,2004.0,9.7,15,8,6,5,4,8,20,40.0,12,12,5,7,10,25,22,0
965,Matthias Ginter,GER,DF,Freiburg,de  Bundesliga,31-051,1994.0,20.5,22,14,11,9,2,13,20,65.0,7,27,18,9,13,35,95,3
966,Jamie Gittens,ENG,"FW,MF",Dortmund,de  Bundesliga,20-215,2004.0,17.7,27,17,9,11,7,13,17,76.5,4,15,0,15,8,35,4,0
967,Serge Gnabry,GER,"FW,MF",Bayern Munich,de  Bundesliga,29-240,1995.0,8.5,15,9,6,4,5,7,11,63.6,4,8,0,8,5,20,7,0
968,Ben Godfrey,ENG,DF,Ipswich Town,eng  Premier League,27-055,1998.0,1.2,0,0,0,0,0,0,0,,0,1,1,0,2,2,1,0
969,Ben Godfrey,ENG,DF,Atalanta,it  Serie A,27-055,1998.0,0.3,0,0,0,0,0,0,1,0.0,1,1,1,0,0,0,0,0
970,Martial Godo,ENG,FW,Fulham,eng  Premier League,21-362,2003.0,0.2,0,0,0,0,0,0,0,,0,1,0,1,1,1,0,0
971,Saba Goglichidze,GEO,DF,Empoli,it  Serie A,20-259,2004.0,21.6,51,30,30,19,2,20,39,51.3,19,30,14,16,27,78,72,3
972,Edoardo Goldaniga,ITA,DF,Como,it  Serie A,31-129,1993.0,19.1,26,16,16,5,5,11,14,78.6,3,14,6,8,22,48,68,2
973,Pierluigi Gollini,ITA,GK,Genoa,it  Serie A,29-358,1995.0,7.0,0,0,0,0,0,0,0,,0,1,0,1,0,0,2,1
974,Aleksandr Golovin,RUS,"MF,FW",Monaco,fr  Ligue 1,28-285,1996.0,12.6,37,24,9,19,9,17,37,45.9,20,15,4,11,11,48,6,0
975,André Gomes,POR,MF,Lille,fr  Ligue 1,31-224,1993.0,8.7,20,10,6,9,5,7,22,31.8,15,5,1,4,6,26,8,1
976,Angel Gomes,ENG,MF,Lille,fr  Ligue 1,24-192,2000.0,8.2,10,6,4,4,2,2,12,16.7,10,0,0,0,0,10,2,0
977,João Gomes,BRA,MF,Wolves,eng  Premier League,24-027,2001.0,24.0,78,43,39,36,3,32,80,40.0,48,31,3,28,20,98,29,0
978,Rodrigo Gomes,POR,"DF,FW",Wolves,eng  Premier League,21-247,2003.0,6.3,19,12,10,9,0,9,17,52.9,8,8,1,7,4,23,17,1
979,Toti Gomes,POR,DF,Wolves,eng  Premier League,26-054,1999.0,19.0,41,30,27,12,2,20,24,83.3,4,21,14,7,17,58,90,4
980,Carlos Gómez,COL,"MF,FW",Rennes,fr  Ligue 1,22-180,2002.0,3.5,7,6,2,4,1,3,9,33.3,6,5,0,5,2,9,2,0
981,Dani Gómez,ESP,FW,Valencia,es  La Liga,26-224,1998.0,5.9,3,2,0,0,3,0,0,,0,1,0,1,2,5,4,0
982,Diego Gómez,PAR,MF,Brighton,eng  Premier League,21-349,2003.0,2.0,6,4,3,2,1,3,9,33.3,6,8,0,8,3,9,3,1
983,Joe Gomez,ENG,DF,Liverpool,eng  Premier League,27-292,1997.0,5.8,13,10,5,7,1,11,16,68.8,5,9,6,3,7,20,20,2
984,Moi Gómez,ESP,"MF,FW",Osasuna,es  La Liga,30-261,1994.0,7.4,11,7,3,6,2,3,6,50.0,3,4,1,3,5,16,5,1
985,Sergi Gómez,ESP,DF,Espanyol,es  La Liga,32-348,1992.0,7.2,8,5,7,1,0,2,3,66.7,1,12,8,4,7,15,36,0
986,Sergio Gómez,ESP,"MF,DF",Real Sociedad,es  La Liga,24-188,2000.0,22.2,53,33,22,23,8,21,42,50.0,21,35,2,33,15,68,22,1
987,Unai Gómez,ESP,"MF,FW",Athletic Club,es  La Liga,21-290,2003.0,8.4,6,2,2,3,1,3,3,100.0,0,8,0,8,2,8,8,0
988,Tidiam Gomis,FRA,MF,RB Leipzig,de  Bundesliga,18-215,2006.0,0.0,0,0,0,0,0,0,0,,0,1,0,1,0,0,0,0
989,Fabio González,ESP,MF,Las Palmas,es  La Liga,28-027,1997.0,0.6,0,0,0,0,0,0,1,0.0,1,0,0,0,0,0,0,0
990,Nicolás González,ESP,MF,Manchester City,eng  Premier League,23-067,2002.0,3.3,4,0,1,3,0,1,1,100.0,0,5,0,5,2,6,6,0
991,Nicolás González,ARG,FW,Juventus,it  Serie A,26-339,1998.0,11.3,18,9,8,6,4,7,17,41.2,10,12,3,9,6,24,17,1
992,Urko González,ESP,MF,Espanyol,es  La Liga,23-356,2001.0,3.7,15,8,9,5,1,10,13,76.9,3,7,3,4,3,18,13,0
993,Urko González,ESP,MF,Real Sociedad,es  La Liga,23-356,2001.0,0.5,0,0,0,0,0,0,0,,0,1,1,0,0,0,0,0
994,Anthony Gordon,ENG,FW,Newcastle Utd,eng  Premier League,24-015,2001.0,23.4,28,17,9,16,3,11,32,34.4,21,24,2,22,6,34,9,2
995,Leon Goretzka,GER,MF,Bayern Munich,de  Bundesliga,30-033,1995.0,10.9,16,9,4,11,1,8,17,47.1,9,20,4,16,11,27,17,1
996,Mathieu Gorgelin,FRA,GK,Le Havre,fr  Ligue 1,34-218,1990.0,8.0,1,1,1,0,0,1,1,100.0,0,0,0,0,0,1,4,0
997,Andoni Gorosabel,ESP,DF,Athletic Club,es  La Liga,28-219,1996.0,10.2,28,13,17,7,4,15,26,57.7,11,13,1,12,10,38,30,0
998,Robin Gosens,GER,DF,Fiorentina,it  Serie A,30-249,1994.0,21.9,48,29,27,14,7,23,40,57.5,17,25,6,19,15,63,73,0
999,Robin Gosens,GER,DF,Union Berlin,de  Bundesliga,30-249,1994.0,1.0,0,0,0,0,0,0,3,0.0,3,1,0,1,1,1,2,0
1000,Mario Götze,GER,"MF,FW",Eint Frankfurt,de  Bundesliga,32-281,1992.0,14.1,34,22,14,17,3,13,31,41.9,18,10,1,9,6,40,8,0
1001,Amine Gouiri,ALG,"FW,MF",Marseille,fr  Ligue 1,25-023,2000.0,5.1,3,3,0,0,3,2,2,100.0,0,4,0,4,0,3,1,0
1002,Amine Gouiri,ALG,"MF,FW",Rennes,fr  Ligue 1,25-023,2000.0,11.5,9,6,4,4,1,2,8,25.0,6,8,0,8,2,11,5,0
1003,Lucas Gourna-Douath,FRA,MF,Roma,it  Serie A,21-218,2003.0,1.5,5,2,3,2,0,1,2,50.0,1,1,1,0,0,5,1,0
1004,Jeffrey Gouweleeuw,NED,DF,Augsburg,de  Bundesliga,33-244,1991.0,23.7,37,21,19,14,4,18,27,66.7,9,25,11,14,24,61,127,0
1005,Kamil Grabara,POL,GK,Wolfsburg,de  Bundesliga,26-062,1999.0,19.7,0,0,0,0,0,0,2,0.0,2,1,0,1,0,0,8,2
1006,Jonathan Gradit,FRA,DF,Lens,fr  Ligue 1,32-107,1992.0,16.5,31,15,17,12,2,18,30,60.0,12,17,6,11,22,53,81,1
1007,José Gragera,ESP,MF,Espanyol,es  La Liga,24-101,2000.0,6.3,25,16,11,14,0,9,17,52.9,8,9,1,8,5,30,13,0
1008,Samuel Grandsir,FRA,"MF,FW",Le Havre,fr  Ligue 1,28-209,1996.0,0.9,5,5,0,3,2,2,3,66.7,1,2,0,2,0,5,0,0
1009,Alberto Grassi,ITA,MF,Empoli,it  Serie A,30-004,1995.0,15.9,30,16,11,15,4,10,14,71.4,4,17,10,7,21,51,31,1
1010,Ryan Gravenberch,NED,MF,Liverpool,eng  Premier League,22-299,2002.0,27.5,52,28,20,22,10,25,43,58.1,18,30,8,22,50,102,50,0
1011,Archie Gray,ENG,DF,Tottenham,eng  Premier League,18-364,2006.0,12.8,10,4,3,4,3,5,14,35.7,9,14,8,6,8,18,37,2
1012,Jack Grealish,ENG,"FW,MF",Manchester City,eng  Premier League,29-182,1995.0,6.8,9,5,4,2,3,2,4,50.0,2,11,2,9,2,11,4,1
1013,Jacob Greaves,ENG,DF,Ipswich Town,eng  Premier League,24-180,2000.0,18.0,27,13,11,15,1,14,22,63.6,8,27,19,8,17,44,101,2
1014,Mason Greenwood,ENG,"FW,MF",Marseille,fr  Ligue 1,23-161,2001.0,23.0,31,15,10,12,9,15,34,44.1,19,4,0,4,9,40,5,2
1015,Michael Gregoritsch,AUT,FW,Freiburg,de  Bundesliga,30-327,1994.0,4.7,3,2,1,0,2,0,3,0.0,3,2,1,1,0,3,7,0
1016,Dominik Greif,SVK,GK,Mallorca,es  La Liga,27-339,1997.0,22.0,0,0,0,0,0,0,0,,0,0,0,0,0,0,5,1
1017,Antoine Griezmann,FRA,"FW,MF",Atlético Madrid,es  La Liga,33-355,1991.0,21.5,26,14,12,10,4,7,25,28.0,18,11,0,11,6,32,19,1
1018,Vincenzo Grifo,ITA,"FW,MF",Freiburg,de  Bundesliga,31-338,1993.0,19.2,17,14,7,9,1,8,25,32.0,17,14,1,13,3,20,12,1
1019,Florian Grillitsch,AUT,MF,Valladolid,es  La Liga,29-216,1995.0,2.7,4,4,3,1,0,2,6,33.3,4,7,1,6,2,6,4,0
1020,Florian Grillitsch,AUT,MF,Hoffenheim,de  Bundesliga,29-216,1995.0,6.7,15,9,5,9,1,8,14,57.1,6,6,2,4,8,23,18,0
1021,Álex Grimaldo,ESP,DF,Leverkusen,de  Bundesliga,29-172,1995.0,21.6,19,10,10,5,4,13,34,38.2,21,14,2,12,14,33,32,2
1022,Pascal Groß,GER,"MF,DF",Dortmund,de  Bundesliga,33-269,1991.0,19.1,38,25,10,21,7,10,38,26.3,28,26,5,21,8,46,19,1
1023,Brajan Gruda,GER,"FW,MF",Brighton,eng  Premier League,20-284,2004.0,4.2,9,4,2,5,2,6,11,54.5,5,7,0,7,2,11,3,0
1024,Marco Grüll,AUT,"FW,MF",Werder Bremen,de  Bundesliga,26-248,1998.0,11.4,9,6,1,3,5,3,14,21.4,11,12,1,11,3,12,6,0
1025,Albert Grønbaek,DEN,"MF,FW",Southampton,eng  Premier League,23-292,2001.0,1.5,4,1,1,1,2,3,10,30.0,7,1,1,0,0,4,1,0
1026,Albert Grønbaek,DEN,"MF,FW",Rennes,fr  Ligue 1,23-292,2001.0,9.0,21,11,10,7,4,10,28,35.7,18,9,1,8,4,25,6,0
1027,Vicente Guaita,ESP,GK,Celta Vigo,es  La Liga,38-060,1987.0,23.0,0,0,0,0,0,0,0,,0,0,0,0,0,0,16,1
1028,Sergi Guardiola,ESP,FW,Rayo Vallecano,es  La Liga,33-286,1991.0,2.9,3,2,0,3,0,0,1,0.0,1,0,0,0,1,4,2,0
1029,Nemanja Gudelj,SRB,"DF,MF",Sevilla,es  La Liga,33-115,1991.0,20.8,31,15,10,17,4,15,21,71.4,6,19,6,13,21,52,66,0
1030,Gabriel Gudmundsson,SWE,DF,Lille,fr  Ligue 1,25-316,1999.0,16.6,29,21,9,14,6,18,30,60.0,12,15,5,10,12,41,32,3
1031,Gonçalo Guedes,POR,"MF,FW",Wolves,eng  Premier League,28-102,1996.0,8.3,14,4,2,5,7,3,14,21.4,11,9,0,9,5,19,3,0
1032,Axel Gueguin,FRA,FW,Montpellier,fr  Ligue 1,19-352,2005.0,0.3,1,1,0,1,0,1,1,100.0,0,0,0,0,0,1,0,0
1033,Marc Guéhi,ENG,DF,Crystal Palace,eng  Premier League,24-241,2000.0,27.0,48,26,28,18,2,27,40,67.5,13,50,21,29,21,69,128,1
1034,Mattéo Guendouzi,FRA,MF,Lazio,it  Serie A,25-331,1999.0,27.5,27,14,9,13,5,13,35,37.1,22,27,6,21,25,52,36,1
1035,Javier Guerra,ESP,MF,Valencia,es  La Liga,22-069,2003.0,19.4,38,18,13,14,11,19,38,50.0,19,9,0,9,11,49,29,2
1036,Raphaël Guerreiro,POR,"DF,MF",Bayern Munich,de  Bundesliga,31-079,1993.0,13.8,15,9,8,4,3,11,15,73.3,4,8,0,8,9,24,12,1
1037,Evann Guessand,CIV,"FW,MF",Nice,fr  Ligue 1,23-253,2001.0,23.7,36,23,9,15,12,5,12,41.7,7,21,3,18,13,49,13,0
1038,Ander Guevara,ESP,MF,Alavés,es  La Liga,27-247,1997.0,15.8,37,23,15,21,1,18,40,45.0,22,18,5,13,8,45,32,1
1039,Pape Gueye,SEN,"MF,FW",Villarreal,es  La Liga,26-046,1999.0,18.6,44,21,17,20,7,16,21,76.2,5,19,7,12,20,64,40,1
1040,Morgan Guilavogui,GUI,"FW,MF",St. Pauli,de  Bundesliga,27-001,1998.0,14.5,31,16,10,16,5,14,27,51.9,13,25,0,25,11,42,27,0
1041,Frederic Guilbert,FRA,DF,Lecce,it  Serie A,30-077,1994.0,20.6,57,30,23,28,6,30,48,62.5,18,20,7,13,38,95,92,3
1042,Luis Guilherme,BRA,"MF,FW",West Ham,eng  Premier League,19-030,2006.0,0.6,1,0,1,0,0,0,0,,0,6,0,6,2,3,1,0
1043,Hugo Guillamón,ESP,MF,Valencia,es  La Liga,25-039,2000.0,4.0,11,8,1,9,1,9,10,90.0,1,3,1,2,5,16,9,1
1044,Bruno Guimarães,BRA,MF,Newcastle Utd,eng  Premier League,27-115,1997.0,26.9,57,34,30,19,8,26,52,50.0,26,27,8,19,25,82,31,3
1045,Carlos Guirao,ESP,MF,Betis,es  La Liga,21-318,2003.0,1.2,5,3,1,4,0,4,6,66.7,2,1,1,0,3,8,2,0
1046,Bahereba Guirassy,FRA,"FW,MF",Nantes,fr  Ligue 1,18-194,2006.0,3.5,9,5,4,2,3,4,10,40.0,6,10,0,10,1,10,4,0
1047,Serhou Guirassy,GUI,FW,Dortmund,de  Bundesliga,28-364,1996.0,21.7,3,2,1,0,2,0,1,0.0,1,7,3,4,3,6,28,0
1048,Marc Guiu,ESP,FW,Chelsea,eng  Premier League,19-066,2006.0,0.8,1,1,0,1,0,1,1,100.0,0,0,0,0,0,1,0,0
1049,Péter Gulácsi,HUN,GK,RB Leipzig,de  Bundesliga,34-309,1990.0,23.5,0,0,0,0,0,0,1,0.0,1,0,0,0,0,0,9,3
1050,Arda Güler,TUR,"MF,FW",Real Madrid,es  La Liga,20-014,2005.0,7.1,17,7,6,4,7,6,13,46.2,7,10,0,10,3,20,6,0
1051,Gerard Gumbau,ESP,MF,Rayo Vallecano,es  La Liga,30-083,1994.0,6.8,14,12,7,6,1,6,12,50.0,6,7,3,4,3,17,10,0
1052,Robert Gumny,POL,DF,Augsburg,de  Bundesliga,26-280,1998.0,1.6,2,2,1,1,0,1,3,33.3,2,1,0,1,0,2,5,0
1053,İlkay Gündoğan,GER,MF,Manchester City,eng  Premier League,34-138,1990.0,16.1,17,10,4,9,4,9,20,45.0,11,9,0,9,12,29,17,0
1054,Christian Günter,GER,DF,Freiburg,de  Bundesliga,32-011,1993.0,22.8,20,18,12,7,1,14,27,51.9,13,21,9,12,8,28,43,1
1055,Jon Guridi,ESP,"MF,FW",Alavés,es  La Liga,30-011,1995.0,15.9,25,13,5,16,4,11,30,36.7,19,17,1,16,10,35,8,0
1056,Gorka Guruzeta,ESP,FW,Athletic Club,es  La Liga,28-180,1996.0,14.4,10,4,0,9,1,6,23,26.1,17,22,3,19,5,15,15,0
1057,Malo Gusto,FRA,DF,Chelsea,eng  Premier League,21-296,2003.0,17.2,40,26,24,14,2,22,42,52.4,20,26,7,19,18,58,38,4
1058,Miguel Gutiérrez,ESP,"DF,MF",Girona,es  La Liga,23-227,2001.0,22.5,33,21,17,13,3,15,30,50.0,15,14,5,9,13,46,26,2
1059,Albert Guðmundsson,ISL,"MF,FW",Fiorentina,it  Serie A,27-269,1997.0,8.6,6,2,2,2,2,5,10,50.0,5,4,0,4,6,12,5,1
1060,Joško Gvardiol,CRO,DF,Manchester City,eng  Premier League,23-047,2002.0,26.4,43,28,19,14,10,17,32,53.1,15,31,14,17,29,72,83,7
1061,Emmanuel Gyasi,GHA,"DF,FW",Empoli,it  Serie A,31-059,1994.0,27.1,51,28,31,14,6,24,34,70.6,10,19,7,12,6,57,66,0
1062,Christian Gytkjær,DEN,FW,Venezia,it  Serie A,34-309,1990.0,3.6,3,1,2,1,0,1,2,50.0,1,1,1,0,0,3,4,0
1063,Erling Haaland,NOR,FW,Manchester City,eng  Premier League,24-233,2000.0,26.6,9,5,3,3,3,2,6,33.3,4,10,1,9,4,13,22,0
1064,Nicolas Haas,SUI,MF,Empoli,it  Serie A,29-047,1996.0,3.2,11,8,4,5,2,5,9,55.6,4,2,1,1,4,15,6,0
1065,Janik Haberer,GER,"MF,DF",Union Berlin,de  Bundesliga,30-343,1994.0,10.9,17,12,5,10,2,13,24,54.2,11,9,0,9,10,27,21,0
1066,Robin Hack,GER,FW,Gladbach,de  Bundesliga,26-196,1998.0,16.8,17,13,8,6,3,11,23,47.8,12,17,1,16,6,23,23,0
1067,Saad El Haddad,MAR,MF,Venezia,it  Serie A,19-230,2005.0,0.3,0,0,0,0,0,0,0,,0,0,0,0,0,0,0,0
1068,Munir El Haddadi,MAR,"FW,MF",Leganés,es  La Liga,29-191,1995.0,5.7,11,8,5,4,2,3,9,33.3,6,6,1,5,0,11,1,1
1069,Amadou Haidara,MLI,MF,RB Leipzig,de  Bundesliga,27-039,1998.0,12.3,23,13,9,13,1,9,21,42.9,12,34,9,25,17,40,50,0
1070,Massadio Haïdara,MLI,DF,Brest,fr  Ligue 1,32-099,1992.0,11.7,12,7,8,4,0,5,14,35.7,9,7,0,7,13,25,54,0
1071,Antoine Hainaut,FRA,"DF,MF",Parma,it  Serie A,23-021,2002.0,9.1,19,11,11,5,3,9,11,81.8,2,11,3,8,12,31,37,0
1072,Mohamed Haj,TUN,MF,Parma,it  Serie A,19-350,2005.0,4.7,3,1,2,1,0,1,2,50.0,1,3,1,2,4,7,5,0
1073,Achraf Hakimi,MAR,DF,Paris S-G,fr  Ligue 1,26-127,1998.0,18.3,40,30,16,16,8,24,41,58.5,17,21,2,19,27,67,13,2
1074,Lewis Hall,ENG,DF,Newcastle Utd,eng  Premier League,20-184,2004.0,24.3,58,41,28,22,8,40,74,54.1,34,33,18,15,18,76,75,3
1075,Sébastien Haller,CIV,FW,Leganés,es  La Liga,30-262,1994.0,4.5,2,0,1,0,1,1,2,50.0,1,1,0,1,0,2,7,0
1076,Ali Al Hamadi,IRQ,FW,Ipswich Town,eng  Premier League,23-010,2002.0,1.5,1,0,0,0,1,0,2,0.0,2,0,0,0,0,1,2,0
1077,Andreas Hanche-Olsen,NOR,DF,Mainz 05,de  Bundesliga,28-053,1997.0,7.6,9,3,4,4,1,2,4,50.0,2,16,12,4,5,14,40,1
1078,Florent Hanin,ALG,DF,Angers,fr  Ligue 1,35-035,1990.0,21.1,45,36,27,11,7,25,46,54.3,21,18,6,12,37,82,72,2
1079,Ridgeciano Haps,SUR,DF,Venezia,it  Serie A,31-272,1993.0,11.3,17,10,14,2,1,9,15,60.0,6,14,3,11,6,23,39,0
1080,Amine Harit,MAR,MF,Marseille,fr  Ligue 1,27-266,1997.0,5.2,7,6,0,5,2,1,2,50.0,1,6,0,6,3,10,1,1
1081,Marcus Harness,ENG,MF,Ipswich Town,eng  Premier League,29-015,1996.0,0.5,1,0,0,0,1,0,3,0.0,3,2,1,1,0,1,1,0
1082,Phil Harres,GER,FW,Holstein Kiel,de  Bundesliga,22-351,2002.0,14.5,10,10,3,4,3,4,7,57.1,3,13,3,10,4,14,12,0
1083,Jack Harrison,ENG,FW,Everton,eng  Premier League,28-111,1996.0,15.8,24,16,9,8,7,12,26,46.2,14,10,0,10,6,30,23,2
1084,Abdou Harroui,NED,"MF,FW",Hellas Verona,it  Serie A,27-057,1998.0,5.1,9,6,6,3,0,4,4,100.0,0,5,0,5,2,11,5,0
1085,Taylor Harwood-Bellis,ENG,DF,Southampton,eng  Premier League,23-040,2002.0,22.6,25,17,12,10,3,17,27,63.0,10,54,34,20,27,52,98,6
1086,Hans Hateboer,NED,DF,Rennes,fr  Ligue 1,31-061,1994.0,16.7,29,15,14,10,5,17,33,51.5,16,17,6,11,26,55,59,2
1087,Kjetil Haug,NOR,GK,Toulouse,fr  Ligue 1,26-272,1998.0,4.5,0,0,0,0,0,0,0,,0,0,0,0,0,0,3,0
1088,Kai Havertz,GER,"FW,MF",Arsenal,eng  Premier League,25-273,1999.0,20.4,16,9,3,6,7,4,15,26.7,11,22,4,18,6,22,31,1
1089,Ayden Heaven,ENG,DF,Manchester Utd,eng  Premier League,18-170,2006.0,0.5,1,1,0,1,0,1,1,100.0,0,0,0,0,1,2,3,0
1090,Jan Paul van Hecke,NED,DF,Brighton,eng  Premier League,24-276,2000.0,24.9,37,25,19,17,1,18,33,54.5,15,32,19,13,21,58,102,2
1091,Hwang Hee-chan,KOR,"MF,FW",Wolves,eng  Premier League,29-044,1996.0,7.1,6,4,2,1,3,2,6,33.3,4,9,0,9,2,8,11,0
1092,Dean Henderson,ENG,GK,Crystal Palace,eng  Premier League,27-364,1997.0,28.0,2,1,2,0,0,2,5,40.0,3,0,0,0,0,2,18,0
1093,Liam Henderson,SCO,MF,Empoli,it  Serie A,28-320,1996.0,18.9,34,16,14,18,2,18,44,40.9,26,15,5,10,13,47,33,0
1094,Ramon Hendriks,NED,DF,Stuttgart,de  Bundesliga,23-236,2001.0,8.7,14,5,7,7,0,6,10,60.0,4,7,0,7,13,27,41,0
1095,Paul Hennrich,GER,MF,Hoffenheim,de  Bundesliga,20-005,2005.0,0.1,0,0,0,0,0,0,0,,0,1,1,0,0,0,0,0
1096,Benjamin Henrichs,GER,DF,RB Leipzig,de  Bundesliga,28-016,1997.0,10.4,32,16,18,10,4,14,27,51.9,13,22,3,19,15,47,33,0
1097,Luis Henrique,BRA,"DF,FW",Marseille,fr  Ligue 1,23-087,2001.0,21.8,13,8,5,6,2,7,8,87.5,1,10,2,8,5,18,26,0
1098,Rico Henry,ENG,DF,Brentford,eng  Premier League,27-246,1997.0,0.0,0,0,0,0,0,0,1,0.0,1,0,0,0,1,1,0,0
1099,Mads Hermansen,DEN,GK,Leicester City,eng  Premier League,24-243,2000.0,20.5,1,1,1,0,0,1,1,100.0,0,1,0,1,0,1,9,2
1100,Mario Hermoso,ESP,DF,Roma,it  Serie A,29-266,1995.0,2.8,2,1,2,0,0,0,1,0.0,1,1,1,0,4,6,13,0
1101,Mario Hermoso,ESP,DF,Leverkusen,de  Bundesliga,29-266,1995.0,3.3,0,0,0,0,0,0,0,,0,3,1,2,9,9,15,1
1102,Javi Hernández,ESP,DF,Leganés,es  La Liga,26-313,1998.0,16.6,21,14,12,6,3,12,32,37.5,20,19,3,16,19,40,69,0
1103,Aridane Hernández,ESP,DF,Rayo Vallecano,es  La Liga,35-353,1989.0,3.9,3,2,3,0,0,0,0,,0,4,2,2,3,6,23,0
1104,Lucas Hernández,FRA,DF,Paris S-G,fr  Ligue 1,29-025,1996.0,5.1,18,14,8,8,2,11,16,68.8,5,5,2,3,3,21,18,1
1105,Theo Hernández,FRA,DF,Milan,it  Serie A,27-156,1997.0,22.5,25,19,18,4,3,15,27,55.6,12,16,6,10,14,39,55,3
1106,Hernani,BRA,MF,Parma,it  Serie A,30-349,1994.0,11.1,31,19,14,13,4,16,34,47.1,18,18,4,14,15,46,8,1
1107,Jorge Herrando,ESP,DF,Osasuna,es  La Liga,24-011,2001.0,8.2,8,6,4,4,0,3,7,42.9,4,11,8,3,5,13,36,2
1108,Ander Herrera,ESP,MF,Athletic Club,es  La Liga,35-209,1989.0,3.0,8,4,1,7,0,3,6,50.0,3,1,0,1,2,10,10,0
1109,Sergio Herrera,ESP,GK,Osasuna,es  La Liga,31-279,1993.0,26.0,2,1,2,0,0,2,5,40.0,3,1,0,1,0,2,22,1
1110,Yangel Herrera,VEN,MF,Girona,es  La Liga,27-056,1998.0,15.8,43,27,20,20,3,21,38,55.3,17,13,2,11,24,67,35,1
1111,Juan Herzog,ESP,DF,Las Palmas,es  La Liga,21-302,2003.0,8.0,8,8,8,0,0,6,8,75.0,2,7,3,4,10,18,48,0
1112,Son Heung-min,KOR,FW,Tottenham,eng  Premier League,32-246,1992.0,20.1,16,9,3,8,5,5,20,25.0,15,8,0,8,4,20,16,1
1113,Isak Hien,SWE,DF,Atalanta,it  Serie A,26-057,1999.0,17.9,38,24,20,18,0,20,30,66.7,10,21,13,8,20,58,53,1
1114,Omar El Hilali,MAR,DF,Espanyol,es  La Liga,21-180,2003.0,24.4,92,64,66,21,5,50,77,64.9,27,34,7,27,31,123,102,2
1115,James Hill,ENG,DF,Bournemouth,eng  Premier League,23-060,2002.0,4.6,13,6,6,5,2,3,9,33.3,6,3,0,3,9,22,27,0
1116,Piero Hincapié,ECU,DF,Leverkusen,de  Bundesliga,23-061,2002.0,21.5,37,31,18,13,6,18,31,58.1,13,28,13,15,27,64,65,1
1117,Jack Hinshelwood,ENG,"MF,DF",Brighton,eng  Premier League,19-334,2005.0,12.9,19,14,7,8,4,8,17,47.1,9,6,3,3,8,27,28,1
1118,George Hirst,ENG,FW,Ipswich Town,eng  Premier League,26-024,1999.0,2.9,1,1,1,0,0,0,1,0.0,1,0,0,0,1,2,5,0
1119,Adam Hložek,CZE,"FW,MF",Hoffenheim,de  Bundesliga,22-229,2002.0,16.5,19,8,7,6,6,11,20,55.0,9,12,1,11,4,23,18,0
1120,Ki-Jana Hoever,NED,DF,Auxerre,fr  Ligue 1,23-052,2002.0,17.1,41,28,22,13,6,22,39,56.4,17,24,3,21,16,57,51,0
1121,Nicolas Höfler,GER,MF,Freiburg,de  Bundesliga,35-002,1990.0,8.5,33,23,13,18,2,20,31,64.5,11,7,1,6,13,46,28,1
1122,Jonas Hofmann,GER,"MF,DF",Leverkusen,de  Bundesliga,32-240,1992.0,2.7,0,0,0,0,0,0,2,0.0,2,2,0,2,0,0,2,0
1123,Philipp Hofmann,GER,FW,Bochum,de  Bundesliga,31-346,1993.0,19.9,14,12,4,5,5,6,12,50.0,6,10,0,10,4,18,26,0
1124,Lucas Höler,GER,"FW,MF",Freiburg,de  Bundesliga,30-244,1994.0,14.2,24,13,11,11,2,6,19,31.6,13,23,7,16,6,30,20,0
1125,Mason Holgate,ENG,"FW,DF",Everton,eng  Premier League,28-140,1996.0,0.1,0,0,0,0,0,0,0,,0,0,0,0,0,0,0,0
1126,Benedict Hollerbach,GER,"FW,MF",Union Berlin,de  Bundesliga,23-298,2001.0,21.0,36,18,7,19,10,18,38,47.4,20,26,0,26,2,38,9,1
1127,Emil Holm,SWE,DF,Bologna,it  Serie A,24-302,2000.0,9.6,29,17,13,13,3,17,26,65.4,9,15,4,11,8,37,38,1
1128,Lewis Holtby,GER,MF,Holstein Kiel,de  Bundesliga,34-174,1990.0,12.0,30,18,17,9,4,10,24,41.7,14,12,2,10,20,50,26,3
1129,Gerrit Holtmann,PHI,"DF,FW",Bochum,de  Bundesliga,29-351,1995.0,9.0,16,12,9,6,1,7,15,46.7,8,9,1,8,11,27,11,0
1130,Franck Honorat,FRA,FW,Gladbach,de  Bundesliga,28-212,1996.0,10.9,9,2,4,2,3,1,4,25.0,3,7,1,6,4,13,21,1
1131,Mathias Honsak,AUT,"FW,DF",Heidenheim,de  Bundesliga,28-081,1996.0,11.9,15,8,10,5,0,10,21,47.6,11,17,4,13,7,22,28,0
1132,Dinko Horkaš,CRO,GK,Las Palmas,es  La Liga,26-001,1999.0,2.3,0,0,0,0,0,0,0,,0,0,0,0,0,0,2,0
1133,Timo Horn,GER,GK,Bochum,de  Bundesliga,31-303,1993.0,4.0,0,0,0,0,0,0,0,,0,0,0,0,0,0,2,1
1134,Cédric Hountondji,BEN,DF,Angers,fr  Ligue 1,31-051,1994.0,3.0,6,4,4,2,0,3,7,42.9,4,3,3,0,4,10,14,0
1135,Ilyes Housni,FRA,"FW,MF",Le Havre,fr  Ligue 1,19-301,2005.0,2.5,7,5,2,3,2,2,4,50.0,2,2,0,2,1,8,2,0
1136,Lukáš Hrádecký,FIN,GK,Leverkusen,de  Bundesliga,35-107,1989.0,22.0,0,0,0,0,0,0,1,0.0,1,0,0,0,0,0,5,1
1137,Robin Hranáč,CZE,DF,Hoffenheim,de  Bundesliga,25-041,2000.0,2.4,0,0,0,0,0,0,1,0.0,1,3,2,1,5,5,9,1
1138,Callum Hudson-Odoi,ENG,"FW,MF",Nott'ham Forest,eng  Premier League,24-124,2000.0,20.2,15,10,5,6,4,7,12,58.3,5,10,0,10,13,28,10,1
1139,Will Hughes,ENG,MF,Crystal Palace,eng  Premier League,29-328,1995.0,18.2,61,33,17,31,13,27,58,46.6,31,27,12,15,16,77,18,1
1140,Dean Huijsen,ESP,DF,Bournemouth,eng  Premier League,19-331,2005.0,17.8,27,19,12,14,1,13,21,61.9,8,32,24,8,40,67,121,3
1141,Mats Hummels,GER,DF,Roma,it  Serie A,36-085,1988.0,8.7,26,12,14,12,0,10,17,58.8,7,12,4,8,23,49,31,0
1142,Omari Hutchinson,ENG,"MF,FW",Ipswich Town,eng  Premier League,21-132,2003.0,23.7,29,10,13,9,7,13,44,29.5,31,22,1,21,10,39,13,1
1143,Elseid Hysaj,ALB,DF,Lazio,it  Serie A,31-019,1994.0,2.3,7,5,4,3,0,3,3,100.0,0,2,2,0,3,10,11,0
1144,Hong Hyunseok,KOR,MF,Mainz 05,de  Bundesliga,25-268,1999.0,4.9,6,2,3,2,1,1,4,25.0,3,6,1,5,7,13,7,0
1145,Pierre Højbjerg,DEN,MF,Marseille,fr  Ligue 1,29-218,1995.0,23.9,48,31,20,23,5,29,59,49.2,30,26,4,22,37,85,29,1
1146,Oscar Højlund,DEN,MF,Eint Frankfurt,de  Bundesliga,20-066,2005.0,5.5,16,9,5,7,4,7,14,50.0,7,10,5,5,4,20,6,0
1147,Rasmus Højlund,DEN,FW,Manchester Utd,eng  Premier League,22-035,2003.0,15.0,3,1,0,2,1,0,4,0.0,4,3,0,3,1,4,3,0
1148,Pablo Ibáñez,ESP,MF,Osasuna,es  La Liga,26-172,1998.0,7.7,11,5,5,5,1,6,18,33.3,12,13,5,8,12,23,15,0
1149,Hafiz Ibrahim,NGA,FW,Reims,fr  Ligue 1,19-081,2005.0,0.5,0,0,0,0,0,0,0,,0,0,0,0,0,0,1,0
1150,Arijon Ibrahimović,GER,FW,Bayern Munich,de  Bundesliga,19-090,2005.0,0.0,0,0,0,0,0,0,0,,0,0,0,0,0,0,0,0
1151,Stanis Idumbo,BEL,"FW,MF",Sevilla,es  La Liga,19-255,2005.0,2.8,8,5,3,3,2,2,4,50.0,2,3,1,2,4,12,1,0
1152,Jay Idzes,IDN,DF,Venezia,it  Serie A,24-282,2000.0,25.7,35,24,20,11,4,12,24,50.0,12,37,20,17,21,56,114,0
1153,Iglesias,ESP,DF,Getafe,es  La Liga,26-251,1998.0,22.9,63,39,31,26,6,34,70,48.6,36,35,6,29,36,99,99,1
1154,Borja Iglesias,ESP,FW,Celta Vigo,es  La Liga,32-053,1993.0,15.9,8,7,1,4,3,2,10,20.0,8,7,2,5,4,12,6,0
1155,Igor,BRA,DF,Brighton,eng  Premier League,27-032,1998.0,10.0,4,4,2,1,1,4,10,40.0,6,23,14,9,4,8,39,1
1156,Kelechi Iheanacho,NGA,FW,Sevilla,es  La Liga,28-159,1996.0,4.4,1,0,0,1,0,1,3,33.3,2,0,0,0,0,1,1,0
1157,Jonathan Ikone,FRA,"FW,MF",Como,it  Serie A,26-313,1998.0,1.3,9,6,1,1,7,2,4,50.0,2,3,1,2,0,9,0,1
1158,Jonathan Ikone,FRA,"FW,MF",Fiorentina,it  Serie A,26-313,1998.0,3.7,5,2,3,2,0,2,4,50.0,2,3,0,3,1,6,1,0
1159,George Ilenikhena,FRA,FW,Monaco,fr  Ligue 1,18-207,2006.0,7.1,1,1,0,1,0,0,1,0.0,1,0,0,0,2,3,0,0
1160,Andrej Ilic,SRB,FW,Union Berlin,de  Bundesliga,24-342,2000.0,4.2,1,1,0,1,0,0,2,0.0,2,3,1,2,2,3,3,0
1161,Ivan Ilić,SRB,MF,Torino,it  Serie A,23-359,2001.0,8.0,3,1,0,2,1,1,5,20.0,4,0,0,0,4,7,6,0
1162,Rareş Ilie,ROU,MF,Nice,fr  Ligue 1,21-326,2003.0,0.1,1,1,1,0,0,1,1,100.0,0,0,0,0,0,1,0,0
1163,Samuel Iling-Junior,ENG,"FW,MF",Bologna,it  Serie A,21-158,2003.0,1.3,3,2,1,1,1,0,1,0.0,1,1,0,1,2,5,2,0
1164,Danny Ings,ENG,"FW,MF",West Ham,eng  Premier League,32-231,1992.0,3.2,4,2,2,2,0,1,3,33.3,2,5,0,5,1,5,4,0
1165,Alessio Iovine,ITA,"DF,FW",Como,it  Serie A,34-038,1991.0,4.2,5,2,2,3,0,4,10,40.0,6,7,1,6,3,8,21,1
1166,Tim Iroegbunam,ENG,MF,Everton,eng  Premier League,21-254,2003.0,5.2,25,12,12,8,5,12,18,66.7,6,10,2,8,11,36,10,1
1167,Jackson Irvine,AUS,MF,St. Pauli,de  Bundesliga,32-004,1993.0,25.0,46,21,20,22,4,20,39,51.3,19,25,4,21,33,79,53,2
1168,Andy Irving,SCO,MF,West Ham,eng  Premier League,24-302,2000.0,1.8,7,4,3,3,1,1,5,20.0,4,5,1,4,1,8,5,0
1169,Alexander Isak,SWE,FW,Newcastle Utd,eng  Premier League,25-171,1999.0,22.8,12,5,2,3,7,5,12,41.7,7,17,2,15,2,14,13,1
1170,Gustav Isaksen,DEN,FW,Lazio,it  Serie A,23-326,2001.0,18.8,12,6,5,7,0,5,23,21.7,18,14,1,13,8,20,15,0
1171,Isco,ESP,MF,Betis,es  La Liga,32-324,1992.0,10.0,13,7,1,8,4,7,22,31.8,15,9,0,9,6,19,3,0
1172,Ismaily,BRA,DF,Lille,fr  Ligue 1,35-059,1990.0,4.3,17,7,8,6,3,9,14,64.3,5,10,1,9,5,22,23,0
1173,Ardian Ismajli,ALB,DF,Empoli,it  Serie A,28-162,1996.0,21.9,20,18,14,6,0,11,14,78.6,3,28,21,7,45,65,195,3
1174,Yanis Issoufou,FRA,"MF,FW",Montpellier,fr  Ligue 1,18-134,2006.0,0.9,6,4,4,1,1,3,5,60.0,2,1,0,1,0,6,1,0
1175,Ko Itakura,JPN,DF,Gladbach,de  Bundesliga,28-043,1997.0,23.0,29,20,16,12,1,16,27,59.3,11,29,14,15,19,48,120,0
1176,Hiroki Ito,JPN,DF,Bayern Munich,de  Bundesliga,25-303,1999.0,2.3,2,0,1,1,0,1,1,100.0,0,2,1,1,5,7,13,1
1177,Junya Ito,JPN,FW,Reims,fr  Ligue 1,32-002,1993.0,24.1,31,22,10,14,7,12,48,25.0,36,29,1,28,13,44,9,1
1178,Marko Ivezić,SRB,DF,Holstein Kiel,de  Bundesliga,23-099,2001.0,15.0,25,16,18,4,3,12,33,36.4,21,22,12,10,23,48,76,2
1179,Alex Iwobi,NGA,"FW,MF",Fulham,eng  Premier League,28-312,1996.0,25.5,31,18,12,15,4,12,22,54.5,10,19,1,18,9,40,26,0
1180,Armando Izzo,ITA,DF,Monza,it  Serie A,33-009,1992.0,23.4,38,15,28,9,1,17,32,53.1,15,35,25,10,38,76,85,0
1181,Fellipe Jack,BRA,DF,Como,it  Serie A,19-058,2006.0,1.9,9,4,8,1,0,3,5,60.0,2,2,2,0,4,13,5,0
1182,Nicolas Jackson,SEN,FW,Chelsea,eng  Premier League,23-264,2001.0,19.3,17,10,4,5,8,2,7,28.6,5,12,2,10,2,19,15,0
1183,Jérémy Jacquet,FRA,DF,Rennes,fr  Ligue 1,19-241,2005.0,4.6,14,9,7,4,3,6,10,60.0,4,1,1,0,16,30,32,1
1184,Lee Jae-sung,KOR,MF,Mainz 05,de  Bundesliga,32-213,1992.0,21.5,31,17,10,16,5,10,26,38.5,16,24,2,22,29,60,29,0
1185,Ivan Jaime Pajuelo,ESP,MF,Valencia,es  La Liga,24-166,2000.0,2.1,4,2,1,1,2,2,3,66.7,1,1,0,1,2,6,0,0
1186,Kristijan Jakić,CRO,MF,Augsburg,de  Bundesliga,27-301,1997.0,18.6,36,16,15,16,5,18,32,56.3,14,32,5,27,24,60,38,1
1187,Karl Jakob Hein,EST,GK,Valladolid,es  La Liga,22-332,2002.0,27.0,0,0,0,0,0,0,2,0.0,2,0,0,0,0,0,16,1
1188,Ismail Jakobs,SEN,DF,Monaco,fr  Ligue 1,25-206,1999.0,2.0,5,5,3,0,2,3,5,60.0,2,0,0,0,2,7,6,0
1189,Jordan James,WAL,MF,Rennes,fr  Ligue 1,20-252,2004.0,10.8,24,14,5,15,4,13,26,50.0,13,12,1,11,12,36,15,1
1190,Reece James,ENG,"DF,MF",Chelsea,eng  Premier League,25-093,1999.0,6.7,7,7,4,3,0,3,9,33.3,6,10,4,6,7,14,12,2
1191,Vitaly Janelt,GER,MF,Brentford,eng  Premier League,26-305,1998.0,22.5,33,20,13,12,8,19,33,57.6,14,29,7,22,25,58,47,1
1192,Adnan Januzaj,BEL,"MF,FW",Las Palmas,es  La Liga,30-034,1995.0,3.6,6,4,1,5,0,4,5,80.0,1,4,0,4,0,6,2,0
1193,Vitezslav Jaros,CZE,GK,Liverpool,eng  Premier League,23-231,2001.0,0.1,0,0,0,0,0,0,0,,0,0,0,0,0,0,0,0
1194,Ali Jasim,IRQ,"FW,DF",Como,it  Serie A,21-050,2004.0,0.1,1,0,1,0,0,1,1,100.0,0,0,0,0,0,1,0,0
1195,Mikel Jauregizar,ESP,MF,Athletic Club,es  La Liga,21-119,2003.0,17.1,56,31,16,30,10,27,57,47.4,30,15,2,13,21,77,17,2
1196,Dominik Javorček,SVK,"DF,MF",Holstein Kiel,de  Bundesliga,22-129,2002.0,4.3,3,0,3,0,0,1,5,20.0,4,7,3,4,5,8,24,1
1197,Gaby Jean,FRA,DF,Lecce,it  Serie A,25-020,2000.0,14.3,13,7,8,4,1,6,10,60.0,4,13,10,3,8,21,66,0
1198,Daniel Jebbison,ENG,FW,Bournemouth,eng  Premier League,21-210,2003.0,0.7,1,0,1,0,0,1,3,33.3,2,1,1,0,1,2,1,0
1199,Finn Jeltsch,GER,DF,Stuttgart,de  Bundesliga,18-237,2006.0,2.0,3,3,1,1,1,1,2,50.0,1,7,3,4,2,5,4,1
1200,Malcolm Jeng,SWE,DF,Reims,fr  Ligue 1,20-002,2005.0,0.5,0,0,0,0,0,0,0,,0,0,0,0,3,3,1,0
1201,Fredrik Jensen,FIN,MF,Augsburg,de  Bundesliga,27-183,1997.0,4.9,4,4,0,2,2,2,3,66.7,1,7,1,6,2,6,14,0
1202,Mathias Jensen,DEN,MF,Brentford,eng  Premier League,29-069,1996.0,8.2,11,8,6,4,1,6,12,50.0,6,11,3,8,6,17,9,1
1203,Moritz Jenz,GER,DF,Mainz 05,de  Bundesliga,25-315,1999.0,12.8,31,19,15,16,0,12,15,80.0,3,15,10,5,17,48,93,0
1204,Gabriel Jesus,BRA,FW,Arsenal,eng  Premier League,27-342,1997.0,6.8,10,6,4,3,3,4,9,44.4,5,10,1,9,4,14,8,0
1205,Juan Jesus,BRA,DF,Napoli,it  Serie A,33-274,1991.0,9.9,21,11,14,7,0,10,17,58.8,7,9,1,8,6,27,33,0
1206,Alejandro Jiménez,ESP,"DF,FW",Milan,it  Serie A,19-307,2005.0,8.5,16,9,5,10,1,6,14,42.9,8,16,1,15,8,24,16,0
1207,Raúl Jiménez,MEX,FW,Fulham,eng  Premier League,33-310,1991.0,19.7,23,13,4,12,7,4,13,30.8,9,17,5,12,9,32,13,3
1208,Kim Jisoo,KOR,DF,Brentford,eng  Premier League,20-077,2004.0,0.3,0,0,0,0,0,0,0,,0,0,0,0,0,0,2,0
1209,João Pedro,BRA,"FW,MF",Brighton,eng  Premier League,23-166,2001.0,17.9,11,7,4,5,2,2,8,25.0,6,9,0,9,6,17,9,0
1210,John Joe,IRL,"MF,FW",Getafe,es  La Liga,21-138,2003.0,0.5,0,0,0,0,0,0,0,,0,1,1,0,0,0,1,0
1211,John Joe,IRL,MF,Reims,fr  Ligue 1,21-138,2003.0,4.4,13,8,9,3,1,3,14,21.4,11,5,0,5,5,18,4,0
1212,Joelinton,BRA,"MF,FW",Newcastle Utd,eng  Premier League,28-209,1996.0,22.3,51,30,22,21,8,21,39,53.8,18,33,6,27,21,72,43,1
1213,Jofre,ESP,"MF,FW",Espanyol,es  La Liga,23-267,2001.0,18.0,16,11,11,4,1,10,18,55.6,8,5,0,5,12,28,22,0
1214,Þórir Jóhann Helgason,ISL,MF,Lecce,it  Serie A,24-164,2000.0,6.8,7,4,1,5,1,4,6,66.7,2,5,2,3,4,11,6,1
1215,Carl Johansson,SWE,DF,Holstein Kiel,de  Bundesliga,30-292,1994.0,4.1,4,2,4,0,0,3,6,50.0,3,7,6,1,6,10,25,1
1216,Ben Johnson,ENG,"DF,FW",Ipswich Town,eng  Premier League,25-046,2000.0,10.6,29,18,18,8,3,16,34,47.1,18,13,4,9,12,41,33,0
1217,Brennan Johnson,WAL,FW,Tottenham,eng  Premier League,23-292,2001.0,19.1,34,21,6,20,8,14,28,50.0,14,18,2,16,4,38,11,0
1218,Karl-Johan Johnsson,SWE,GK,Strasbourg,fr  Ligue 1,35-042,1990.0,3.0,0,0,0,0,0,0,1,0.0,1,0,0,0,0,0,3,0
1219,Sam Johnstone,ENG,GK,Wolves,eng  Premier League,31-351,1993.0,7.0,0,0,0,0,0,0,1,0.0,1,0,0,0,0,0,7,0
1220,Paul Joly,FRA,DF,Auxerre,fr  Ligue 1,24-277,2000.0,8.6,39,26,26,12,1,20,36,55.6,16,13,0,13,22,61,27,5
1221,Curtis Jones,ENG,"MF,FW",Liverpool,eng  Premier League,24-040,2001.0,13.0,29,16,4,19,6,12,20,60.0,8,13,6,7,4,33,6,1
1222,Frenkie de Jong,NED,MF,Barcelona,es  La Liga,27-303,1997.0,6.6,7,3,1,3,3,3,10,30.0,7,4,0,4,3,10,5,0
1223,Joan Jordán,ESP,MF,Alavés,es  La Liga,30-248,1994.0,10.3,23,13,8,12,3,11,21,52.4,10,9,0,9,7,30,11,0
1224,Jorginho,ITA,MF,Arsenal,eng  Premier League,33-081,1991.0,6.0,10,3,1,7,2,6,16,37.5,10,2,0,2,5,15,2,2
1225,Jesse Joronen,FIN,GK,Venezia,it  Serie A,31-355,1993.0,7.8,0,0,0,0,0,0,0,,0,0,0,0,0,0,4,1
1226,Jota,POR,"FW,MF",Rennes,fr  Ligue 1,25-346,1999.0,3.7,5,2,2,3,0,4,7,57.1,3,1,0,1,3,8,2,0
1227,Diogo Jota,POR,FW,Liverpool,eng  Premier League,28-097,1996.0,9.4,7,4,0,5,2,4,16,25.0,12,6,0,6,6,13,5,0
1228,Antoine Joujou,FRA,"MF,FW",Le Havre,fr  Ligue 1,21-364,2003.0,9.0,12,10,7,4,1,7,11,63.6,4,14,3,11,8,20,17,0
1229,Luka Jović,SRB,FW,Milan,it  Serie A,27-078,1997.0,1.4,0,0,0,0,0,0,0,,0,1,1,0,1,1,1,0
1230,Juanmi,ESP,"FW,MF",Getafe,es  La Liga,31-295,1993.0,3.8,8,6,0,6,2,3,7,42.9,4,4,0,4,2,10,3,0
1231,Juanmi,ESP,"FW,MF",Betis,es  La Liga,31-295,1993.0,2.7,7,4,3,3,1,4,6,66.7,2,4,0,4,1,8,4,0
1232,Juanpe,ESP,DF,Girona,es  La Liga,33-315,1991.0,6.7,8,5,5,3,0,6,8,75.0,2,14,9,5,8,16,45,1
1233,Jubal,BRA,DF,Auxerre,fr  Ligue 1,31-194,1993.0,21.4,49,31,40,8,1,24,34,70.6,10,49,25,24,17,66,151,1
1234,Anthony Jung,GER,DF,Werder Bremen,de  Bundesliga,33-128,1991.0,19.7,32,20,20,11,1,20,31,64.5,11,23,14,9,24,56,71,1
1235,Luiz Lúcio Reis Júnior,BRA,GK,Villarreal,es  La Liga,24-056,2001.0,6.2,0,0,0,0,0,0,0,,0,0,0,0,0,0,8,0
1236,Hamed Junior Traorè,CIV,MF,Auxerre,fr  Ligue 1,25-023,2000.0,20.0,41,20,11,17,13,16,52,30.8,36,13,0,13,6,47,11,0
1237,Vinicius Júnior,BRA,FW,Real Madrid,es  La Liga,24-242,2000.0,19.0,17,8,5,3,9,3,12,25.0,9,5,0,5,2,19,1,2
1238,Josip Juranović,CRO,"DF,MF",Union Berlin,de  Bundesliga,29-207,1995.0,8.0,12,6,7,3,2,6,19,31.6,13,8,5,3,5,17,21,1
1239,David Jurásek,CZE,DF,Hoffenheim,de  Bundesliga,24-216,2000.0,4.5,5,3,3,1,1,1,4,25.0,3,3,0,3,3,8,11,0
1240,Stanko Jurić,CRO,MF,Valladolid,es  La Liga,28-207,1996.0,15.0,41,20,22,16,3,16,39,41.0,23,24,7,17,16,57,46,0
1241,James Justin,ENG,DF,Leicester City,eng  Premier League,27-016,1998.0,24.4,44,27,24,16,4,25,44,56.8,19,33,9,24,34,78,107,2
1242,Filip Jørgensen,DEN,GK,Chelsea,eng  Premier League,22-329,2002.0,6.0,0,0,0,0,0,0,0,,0,0,0,0,0,0,0,3
1243,Mohamed Kaba,FRA,MF,Lecce,it  Serie A,23-135,2001.0,2.2,9,4,4,5,0,6,7,85.7,1,4,1,3,2,11,5,1
1244,Yusuf Kabadayı,GER,"FW,MF",Augsburg,de  Bundesliga,21-037,2004.0,0.8,1,0,0,1,0,0,0,,0,1,0,1,0,1,0,0
1245,Almugera Kabar,GER,DF,Dortmund,de  Bundesliga,18-278,2006.0,1.4,5,3,2,2,1,3,3,100.0,0,1,0,1,1,6,3,0
1246,Christian Kabasele,BEL,DF,Udinese,it  Serie A,34-015,1991.0,10.2,12,7,5,7,0,6,8,75.0,2,9,3,6,10,22,44,1
1247,Issa Kaboré,BFA,"DF,FW",Werder Bremen,de  Bundesliga,23-303,2001.0,2.5,6,3,2,3,1,3,5,60.0,2,7,2,5,2,8,7,0
1248,Yaya Kader Fofana,MLI,"MF,FW",Reims,fr  Ligue 1,20-272,2004.0,7.0,17,11,8,5,4,4,12,33.3,8,11,2,9,3,20,2,0
1249,Pavel Kadeřábek,CZE,DF,Hoffenheim,de  Bundesliga,32-320,1992.0,11.7,17,9,8,3,6,11,26,42.3,15,10,3,7,14,31,35,1
1250,Tino Kadewere,ZIM,"MF,FW",Nantes,fr  Ligue 1,29-065,1996.0,5.3,13,7,4,3,6,6,12,50.0,6,3,0,3,5,18,8,0
1251,Ferdi Kadioglu,TUR,"DF,MF",Brighton,eng  Premier League,25-155,1999.0,4.3,10,6,4,5,1,6,15,40.0,9,2,2,0,8,18,17,0
1252,Arnaud Kalimuendo,FRA,FW,Rennes,fr  Ligue 1,23-050,2002.0,21.1,14,10,5,7,2,5,9,55.6,4,7,2,5,4,18,8,0
1253,Pierre Kalulu,FRA,DF,Juventus,it  Serie A,24-279,2000.0,18.6,27,15,20,6,1,12,17,70.6,5,23,14,9,14,41,49,1
1254,Justin-Noël Kalumba,FRA,"FW,MF",Angers,fr  Ligue 1,20-076,2004.0,0.3,0,0,0,0,0,0,0,,0,0,0,0,1,1,1,0
1255,Daichi Kamada,JPN,MF,Crystal Palace,eng  Premier League,28-218,1996.0,11.0,34,17,12,19,3,10,31,32.3,21,16,3,13,13,47,8,0
1256,Waren Kamanzi,NOR,"DF,MF",Toulouse,fr  Ligue 1,24-120,2000.0,8.8,25,12,11,11,3,12,24,50.0,12,3,1,2,7,32,19,0
1257,Boubacar Kamara,FRA,MF,Aston Villa,eng  Premier League,25-108,1999.0,12.0,40,15,23,13,4,25,44,56.8,19,12,5,7,13,53,36,3
1258,Glen Kamara,FIN,MF,Rennes,fr  Ligue 1,29-134,1995.0,7.4,23,11,10,11,2,11,17,64.7,6,7,0,7,7,30,7,0
1259,Hassane Kamara,CIV,DF,Udinese,it  Serie A,31-006,1994.0,15.4,28,22,15,10,3,12,22,54.5,10,17,5,12,20,48,36,0
1260,Willy Kambwala,FRA,DF,Villarreal,es  La Liga,20-198,2004.0,7.5,10,7,7,2,1,4,5,80.0,1,5,4,1,5,15,33,0
1261,Jakub Kamiński,POL,"DF,MF",Wolfsburg,de  Bundesliga,22-279,2002.0,8.4,13,7,6,2,5,6,19,31.6,13,15,6,9,10,23,16,1
1262,Kevin Kampl,SVN,MF,RB Leipzig,de  Bundesliga,34-153,1990.0,15.3,26,18,11,9,6,15,22,68.2,7,23,6,17,23,49,22,0
1263,Nordine Kandil,FRA,MF,Strasbourg,fr  Ligue 1,23-131,2001.0,0.1,0,0,0,0,0,0,0,,0,0,0,0,0,0,1,0
1264,Harry Kane,ENG,FW,Bayern Munich,de  Bundesliga,31-226,1993.0,19.6,7,6,3,3,1,2,5,40.0,3,10,2,8,2,9,7,0
1265,Lee Kang-in,KOR,"FW,MF",Paris S-G,fr  Ligue 1,24-020,2001.0,15.4,20,13,6,8,6,17,31,54.8,14,8,1,7,2,22,3,1
1266,Yann Karamoh,FRA,"MF,FW",Torino,it  Serie A,26-246,1998.0,10.2,5,2,2,1,2,4,9,44.4,5,6,2,4,3,8,5,0
1267,Atakan Karazor,nan,MF,Stuttgart,de  Bundesliga,28-149,1996.0,20.2,41,19,9,23,9,19,42,45.2,23,28,4,24,21,62,32,1
1268,Jesper Karlsson,SWE,FW,Bologna,it  Serie A,26-229,1998.0,3.3,1,0,0,0,1,0,2,0.0,2,4,0,4,0,1,3,0
1269,Jesper Karlsson,SWE,FW,Lecce,it  Serie A,26-229,1998.0,2.5,2,1,2,0,0,2,6,33.3,4,1,0,1,0,2,0,0
1270,Jesper Karlström,SWE,MF,Udinese,it  Serie A,29-263,1995.0,25.6,46,25,25,16,5,19,39,48.7,20,21,10,11,27,73,69,2
1271,Lior Kasa,ISR,"MF,FW",Genoa,it  Serie A,19-165,2005.0,1.7,3,3,1,2,0,1,4,25.0,3,4,1,3,2,5,2,0
1272,Grigoris Kastanos,CYP,"MF,FW",Hellas Verona,it  Serie A,27-040,1998.0,8.3,21,14,7,7,7,8,19,42.1,11,15,2,13,7,28,4,0
1273,Mikkel Kaufmann,DEN,FW,Heidenheim,de  Bundesliga,24-067,2001.0,4.1,6,4,1,3,2,2,5,40.0,3,5,2,3,2,8,7,0
1274,Michael Kayode,ITA,DF,Brentford,eng  Premier League,20-244,2004.0,0.4,1,1,1,0,0,0,0,,0,0,0,0,1,2,1,0
1275,Michael Kayode,ITA,"DF,FW",Fiorentina,it  Serie A,20-244,2004.0,1.4,1,1,1,0,0,0,0,,0,3,1,2,2,3,7,0
1276,Moise Kean,ITA,FW,Fiorentina,it  Serie A,25-011,2000.0,23.1,7,5,1,2,4,3,4,75.0,1,10,0,10,2,9,19,1
1277,Michael Keane,ENG,DF,Everton,eng  Premier League,32-059,1993.0,9.0,10,7,7,2,1,7,10,70.0,3,9,6,3,10,20,50,0
1278,Yassine Kechta,MAR,"MF,FW",Le Havre,fr  Ligue 1,23-014,2002.0,16.0,45,26,23,16,6,25,60,41.7,35,18,2,16,16,61,24,1
1279,Thilo Kehrer,GER,DF,Monaco,fr  Ligue 1,28-171,1996.0,21.0,34,22,24,10,0,19,33,57.6,14,15,9,6,30,64,92,1
1280,Abdoulaye Keita,ESP,"FW,MF",Getafe,es  La Liga,22-191,2002.0,1.1,2,2,0,1,1,2,4,50.0,2,1,0,1,0,2,3,0
1281,Mandela Keita,BEL,MF,Parma,it  Serie A,22-305,2002.0,11.2,29,16,6,19,4,11,19,57.9,8,10,4,6,7,36,15,1
1282,Yannik Keitel,GER,MF,Stuttgart,de  Bundesliga,25-024,2000.0,1.7,5,4,1,3,1,5,6,83.3,1,3,1,2,2,7,3,0
1283,Andu Kelati,GER,"MF,DF",Holstein Kiel,de  Bundesliga,22-210,2002.0,3.2,7,4,2,4,1,2,5,40.0,3,4,1,3,3,10,3,0
1284,Caoimhín Kelleher,IRL,GK,Liverpool,eng  Premier League,26-108,1998.0,8.0,0,0,0,0,0,0,0,,0,0,0,0,0,0,0,2
1285,Thomas Keller,GER,"DF,MF",Heidenheim,de  Bundesliga,25-218,1999.0,1.3,6,5,5,1,0,4,6,66.7,2,3,1,2,4,10,10,0
1286,Lloyd Kelly,ENG,DF,Newcastle Utd,eng  Premier League,26-156,1998.0,3.4,5,4,4,1,0,1,1,100.0,0,6,4,2,1,6,17,0
1287,Lloyd Kelly,ENG,DF,Juventus,it  Serie A,26-156,1998.0,3.5,4,3,0,4,0,3,3,100.0,0,3,3,0,1,5,12,1
1288,Aljoscha Kemlein,GER,MF,Union Berlin,de  Bundesliga,20-221,2004.0,10.2,10,4,4,5,1,5,14,35.7,9,14,3,11,6,16,15,0
1289,Marc-Oliver Kempf,GER,DF,Como,it  Serie A,30-042,1995.0,20.6,24,15,12,11,1,10,20,50.0,10,22,15,7,29,53,91,2
1290,Kenedy,BRA,"MF,FW",Valladolid,es  La Liga,29-031,1996.0,0.1,0,0,0,0,0,0,0,,0,1,0,1,0,0,0,0
1291,Luca Kerber,GER,MF,Heidenheim,de  Bundesliga,23-001,2002.0,7.3,25,16,16,8,1,15,27,55.6,12,10,2,8,3,28,23,0
1292,Milos Kerkez,HUN,DF,Bournemouth,eng  Premier League,21-124,2003.0,27.2,38,21,18,15,5,17,30,56.7,13,29,9,20,34,72,81,2
1293,Reda Khadra,GER,"MF,FW",Reims,fr  Ligue 1,23-250,2001.0,0.9,1,1,1,0,0,0,1,0.0,1,0,0,0,0,1,1,0
1294,Bilal El Khannouss,MAR,MF,Leicester City,eng  Premier League,20-305,2004.0,16.0,36,21,11,20,5,10,18,55.6,8,15,3,12,4,40,4,2
1295,Wahbi Khazri,TUN,"FW,MF",Montpellier,fr  Ligue 1,34-031,1991.0,11.0,22,16,5,13,4,7,19,36.8,12,11,1,10,5,27,7,0
1296,Rani Khedira,GER,MF,Union Berlin,de  Bundesliga,31-043,1994.0,21.3,50,30,21,26,3,20,28,71.4,8,24,9,15,31,81,38,0
1297,Abdukodir Khusanov,UZB,DF,Manchester City,eng  Premier League,21-010,2004.0,4.6,5,4,4,1,0,2,3,66.7,1,5,4,1,3,8,21,1
1298,Abdukodir Khusanov,UZB,DF,Lens,fr  Ligue 1,21-010,2004.0,10.8,15,11,9,5,1,7,11,63.6,4,17,11,6,26,41,57,0
1299,Kialonda,ANG,DF,Lecce,it  Serie A,27-165,1997.0,15.0,24,7,18,6,0,10,12,83.3,2,30,21,9,17,41,73,1
1300,Kiké,ESP,FW,Alavés,es  La Liga,35-106,1989.0,19.7,9,8,1,6,2,2,4,50.0,2,6,2,4,0,9,16,0
1301,Max Kilman,ENG,DF,West Ham,eng  Premier League,27-292,1997.0,27.2,22,11,9,10,3,15,19,78.9,4,47,31,16,31,53,145,4
1302,Joshua Kimmich,GER,MF,Bayern Munich,de  Bundesliga,30-031,1995.0,22.6,39,23,8,25,6,25,38,65.8,13,19,2,17,16,55,19,2
1303,Joshua King,ENG,"MF,FW",Fulham,eng  Premier League,18-067,2007.0,0.9,5,3,2,3,0,0,2,0.0,2,2,0,2,1,6,1,0
1304,Joshua King,NOR,"FW,MF",Toulouse,fr  Ligue 1,33-055,1992.0,13.1,6,6,2,2,2,2,8,25.0,6,8,3,5,3,9,16,0
1305,Antonín Kinský,CZE,GK,Tottenham,eng  Premier League,21-363,2003.0,4.0,3,1,3,0,0,1,1,100.0,0,0,0,0,0,3,5,1
1306,Cédric Kipré,CIV,DF,Reims,fr  Ligue 1,28-092,1996.0,16.8,31,21,23,7,1,24,32,75.0,8,24,13,11,22,53,106,2
1307,Jakub Kiwior,POL,DF,Arsenal,eng  Premier League,25-024,2000.0,3.6,4,2,3,1,0,3,5,60.0,2,5,2,3,1,5,16,1
1308,Tim Kleindienst,GER,FW,Gladbach,de  Bundesliga,29-192,1995.0,23.5,21,12,5,9,7,8,31,25.8,23,37,6,31,9,30,47,0
1309,Lukas Klostermann,GER,DF,RB Leipzig,de  Bundesliga,28-281,1996.0,14.0,21,11,13,6,2,10,17,58.8,7,23,12,11,22,43,96,1
1310,Justin Kluivert,NED,"MF,FW",Bournemouth,eng  Premier League,25-310,1999.0,20.6,20,9,4,10,6,4,17,23.5,13,20,0,20,12,32,21,1
1311,Ansgar Knauff,GER,"MF,DF",Eint Frankfurt,de  Bundesliga,23-060,2002.0,13.0,35,19,17,12,6,10,22,45.5,12,20,4,16,11,46,18,0
1312,Magnus Knudsen,NOR,MF,Holstein Kiel,de  Bundesliga,23-269,2001.0,15.7,39,24,20,14,5,21,35,60.0,14,14,4,10,11,50,36,0
1313,Gregor Kobel,SUI,GK,Dortmund,de  Bundesliga,27-095,1997.0,23.0,0,0,0,0,0,0,0,,0,0,0,0,0,0,10,3
1314,Robin Koch,GER,DF,Eint Frankfurt,de  Bundesliga,28-237,1996.0,19.7,15,7,8,5,2,7,16,43.8,9,32,21,11,18,33,115,3
1315,Hervé Koffi,BFA,GK,Lens,fr  Ligue 1,28-146,1996.0,5.0,1,1,1,0,0,1,1,100.0,0,0,0,0,0,1,5,0
1316,Magnus Kofod Andersen,DEN,MF,Venezia,it  Serie A,25-305,1999.0,7.7,13,4,3,9,1,4,10,40.0,6,7,2,5,6,19,12,0
1317,Derrick Köhn,GER,"DF,FW",Werder Bremen,de  Bundesliga,26-035,1999.0,14.4,19,10,7,9,3,10,13,76.9,3,20,4,16,9,28,24,0
1318,Philipp Köhn,SUI,GK,Monaco,fr  Ligue 1,26-343,1998.0,10.0,0,0,0,0,0,0,1,0.0,1,0,0,0,0,0,6,0
1319,Dominik Kohr,GER,"DF,MF",Mainz 05,de  Bundesliga,31-039,1994.0,22.2,52,39,29,18,5,27,44,61.4,17,37,20,17,40,92,109,0
1320,Koka,EGY,FW,Le Havre,fr  Ligue 1,32-006,1993.0,5.6,3,1,0,3,0,0,4,0.0,4,1,0,1,2,5,5,1
1321,Koke,ESP,MF,Atlético Madrid,es  La Liga,33-062,1992.0,15.9,37,21,13,18,6,19,35,54.3,16,17,1,16,17,54,23,1
1322,Sead Kolašinac,BIH,DF,Atalanta,it  Serie A,31-264,1993.0,17.7,31,20,17,14,0,11,20,55.0,9,11,4,7,19,50,45,1
1323,Randal Kolo Muani,FRA,FW,Juventus,it  Serie A,26-096,1998.0,5.9,6,3,1,3,2,1,2,50.0,1,3,0,3,0,6,2,0
1324,Randal Kolo Muani,FRA,FW,Paris S-G,fr  Ligue 1,26-096,1998.0,4.0,4,4,1,1,2,0,2,0.0,2,1,0,1,0,4,5,0
1325,Marco Komenda,CRO,DF,Holstein Kiel,de  Bundesliga,28-105,1996.0,10.8,20,12,11,8,1,7,11,63.6,4,19,10,9,4,24,47,0
1326,Mert Kömür,GER,MF,Augsburg,de  Bundesliga,19-237,2005.0,3.9,3,2,2,0,1,0,0,,0,5,2,3,3,6,4,1
1327,Ibrahima Konaté,FRA,DF,Liverpool,eng  Premier League,25-290,1999.0,21.0,31,21,23,7,1,21,30,70.0,9,23,12,11,10,41,96,1
1328,Ismael Konate,CIV,"FW,MF",Empoli,it  Serie A,18-347,2006.0,0.6,3,1,3,0,0,2,2,100.0,0,1,1,0,0,3,1,0
1329,Geoffrey Kondogbia,CTA,"DF,MF",Marseille,fr  Ligue 1,32-024,1993.0,15.6,41,26,22,17,2,23,27,85.2,4,16,2,14,13,54,42,3
1330,Abdoul Koné,FRA,DF,Reims,fr  Ligue 1,19-323,2005.0,1.3,5,3,4,1,0,3,5,60.0,2,2,1,1,1,6,4,0
1331,Amadou Koné,MLI,MF,Reims,fr  Ligue 1,19-301,2005.0,7.4,31,21,19,12,0,17,22,77.3,5,10,2,8,9,40,14,0
1332,Ismaël Koné,CAN,"MF,FW",Marseille,fr  Ligue 1,22-278,2002.0,4.0,8,4,3,3,2,3,4,75.0,1,4,1,3,4,12,2,1
1333,Ismaël Koné,CAN,MF,Rennes,fr  Ligue 1,22-278,2002.0,2.3,5,2,2,2,1,2,3,66.7,1,4,1,3,3,8,3,0
1334,Manu Koné,FRA,MF,Roma,it  Serie A,23-298,2001.0,19.2,26,17,10,11,5,16,31,51.6,15,16,1,15,13,39,13,0
1335,Ezri Konsa,ENG,DF,Aston Villa,eng  Premier League,27-139,1997.0,24.1,28,16,17,7,4,16,20,80.0,4,16,9,7,19,47,80,2
1336,Teun Koopmeiners,NED,"MF,FW",Juventus,it  Serie A,27-011,1998.0,19.5,26,16,6,17,3,8,26,30.8,18,32,14,18,8,34,25,2
1337,Odilon Kossounou,CIV,DF,Atalanta,it  Serie A,24-066,2001.0,8.0,11,7,7,4,0,4,7,57.1,3,10,2,8,7,18,14,0
1338,Christian Kouamé,CIV,"FW,MF",Fiorentina,it  Serie A,27-095,1997.0,6.9,13,8,4,4,5,0,3,0.0,3,3,1,2,2,15,10,0
1339,Christian Kouamé,CIV,"FW,MF",Empoli,it  Serie A,27-095,1997.0,2.9,5,4,0,3,2,2,3,66.7,1,2,1,1,0,5,2,0
1340,Henri Koudossou,GER,DF,Augsburg,de  Bundesliga,25-189,1999.0,6.7,17,10,6,10,1,11,17,64.7,6,8,2,6,11,28,33,0
1341,Konstantinos Koulierakis,GRE,DF,Wolfsburg,de  Bundesliga,21-103,2003.0,21.1,34,17,22,10,2,20,31,64.5,11,29,11,18,23,57,111,1
1342,Emmanuel Koum Mbondo,FRA,DF,Marseille,fr  Ligue 1,19-034,2006.0,0.1,0,0,0,0,0,0,0,,0,0,0,0,0,0,0,0
1343,Jules Koundé,FRA,DF,Barcelona,es  La Liga,26-119,1998.0,23.0,50,34,23,21,6,39,54,72.2,15,30,5,25,16,66,54,2
1344,Boubakar Kouyaté,MLI,DF,Montpellier,fr  Ligue 1,27-330,1997.0,6.4,16,10,11,5,0,9,17,52.9,8,15,10,5,11,27,52,0
1345,Mateo Kovačić,CRO,MF,Manchester City,eng  Premier League,30-309,1994.0,18.7,53,32,16,30,7,27,55,49.1,28,17,0,17,18,71,19,0
1346,Viktor Kovalenko,UKR,"MF,DF",Empoli,it  Serie A,29-025,1996.0,0.4,2,1,0,2,0,0,1,0.0,1,0,0,0,0,2,0,0
1347,Matej Kovar,CZE,GK,Leverkusen,de  Bundesliga,24-298,2000.0,3.0,0,0,0,0,0,0,0,,0,0,0,0,0,0,0,0
1348,Mateusz Kowalski,POL,MF,Parma,it  Serie A,19-233,2005.0,0.6,0,0,0,0,0,0,0,,0,1,0,1,0,0,1,0
1349,Goduine Koyalipou,CTA,FW,Lens,fr  Ligue 1,25-024,2000.0,4.3,1,1,0,1,0,0,0,,0,0,0,0,0,1,4,0
1350,Caleb Kporha,ENG,DF,Crystal Palace,eng  Premier League,18-239,2006.0,0.1,2,1,2,0,0,2,2,100.0,0,0,0,0,0,2,1,0
1351,Emil Krafth,SWE,DF,Newcastle Utd,eng  Premier League,30-221,1994.0,2.7,2,1,0,1,1,1,2,50.0,1,5,4,1,2,4,10,0
1352,Alex Král,CZE,MF,Espanyol,es  La Liga,26-296,1998.0,25.4,47,30,23,22,2,11,22,50.0,11,26,11,15,23,70,37,0
1353,Andrej Kramarić,CRO,"MF,FW",Hoffenheim,de  Bundesliga,33-265,1991.0,21.9,8,4,2,5,1,4,8,50.0,4,11,2,9,3,11,9,1
1354,Frans Krätzig,GER,"MF,FW",Heidenheim,de  Bundesliga,22-056,2003.0,6.0,12,6,1,7,4,4,8,50.0,4,6,0,6,4,16,5,0
1355,Frans Krätzig,GER,DF,Stuttgart,de  Bundesliga,22-056,2003.0,0.6,2,1,1,0,1,1,3,33.3,2,2,1,1,0,2,1,0
1356,Tom Krauß,GER,MF,Bochum,de  Bundesliga,23-262,2001.0,5.1,20,10,13,5,2,11,22,50.0,11,10,1,9,4,24,9,1
1357,Ladislav Krejčí,CZE,DF,Girona,es  La Liga,25-325,1999.0,17.1,18,13,16,2,0,10,21,47.6,11,18,14,4,26,44,57,1
1358,Rasmus Kristensen,DEN,DF,Eint Frankfurt,de  Bundesliga,27-243,1997.0,20.9,42,22,29,9,4,30,52,57.7,22,38,13,25,17,59,67,0
1359,Thomas Kristensen,DEN,DF,Udinese,it  Serie A,23-053,2002.0,13.0,19,14,10,8,1,13,18,72.2,5,13,10,3,13,32,53,1
1360,Nikola Krstović,MNE,FW,Lecce,it  Serie A,24-340,2000.0,25.9,14,6,4,4,6,5,12,41.7,7,9,6,3,7,21,21,0
1361,Lukas Kübler,GER,DF,Freiburg,de  Bundesliga,32-193,1992.0,16.6,34,17,16,15,3,23,42,54.8,19,27,11,16,45,79,40,3
1362,Takefusa Kubo,JPN,"MF,FW",Real Sociedad,es  La Liga,23-280,2001.0,17.3,21,13,7,8,6,12,27,44.4,15,27,1,26,9,30,9,1
1363,Mohammed Kudus,GHA,"MF,FW",West Ham,eng  Premier League,24-221,2000.0,21.2,30,19,6,15,9,9,25,36.0,16,21,1,20,4,34,5,2
1364,Dejan Kulusevski,SWE,"MF,FW",Tottenham,eng  Premier League,24-320,2000.0,23.9,39,22,14,11,14,16,46,34.8,30,25,3,22,11,50,9,1
1365,Sael Kumbedi,FRA,DF,Lyon,fr  Ligue 1,19-350,2005.0,8.8,23,12,10,9,4,11,14,78.6,3,10,3,7,8,31,31,0
1366,Marash Kumbulla,ALB,DF,Espanyol,es  La Liga,25-031,2000.0,22.2,38,18,26,10,2,16,30,53.3,14,34,25,9,21,59,160,2
1367,Daler Kuzyaev,RUS,MF,Le Havre,fr  Ligue 1,32-055,1993.0,6.3,13,8,7,4,2,2,9,22.2,7,7,4,3,9,22,8,0
1368,Khvicha Kvaratskhelia,GEO,"FW,MF",Napoli,it  Serie A,24-027,2001.0,13.1,15,9,4,10,1,4,15,26.7,11,13,0,13,4,19,7,0
1369,Khvicha Kvaratskhelia,GEO,FW,Paris S-G,fr  Ligue 1,24-027,2001.0,4.6,4,2,0,4,0,1,4,25.0,3,2,0,2,2,6,3,0
1370,Moritz-Broni Kwarteng,GHA,"MF,FW",Bochum,de  Bundesliga,26-317,1998.0,1.9,4,3,1,1,2,1,2,50.0,1,0,0,0,0,4,1,0
1371,Giorgos Kyriakopoulos,GRE,DF,Monza,it  Serie A,29-034,1996.0,23.6,35,22,16,16,3,24,46,52.2,22,25,8,17,18,53,61,0
1372,Luca de la Torre,USA,MF,Celta Vigo,es  La Liga,26-292,1998.0,0.0,0,0,0,0,0,0,0,,0,0,0,0,0,0,0,0
1373,Rémy Labeau Lascary,GLP,"FW,MF",Lens,fr  Ligue 1,22-008,2003.0,7.1,16,10,7,6,3,5,11,45.5,6,5,0,5,1,17,7,0
1374,Gaëtan Laborde,FRA,FW,Nice,fr  Ligue 1,30-312,1994.0,13.2,16,10,8,7,1,7,18,38.9,11,16,4,12,5,21,11,0
1375,Nediljko Labrović,CRO,GK,Augsburg,de  Bundesliga,25-152,1999.0,15.0,0,0,0,0,0,0,0,,0,0,0,0,0,0,12,1
1376,Alexandre Lacazette,FRA,FW,Lyon,fr  Ligue 1,33-287,1991.0,16.2,11,5,3,6,2,4,12,33.3,8,8,1,7,6,17,6,0
1377,Younes Lachaab,FRA,"MF,FW",Lille,fr  Ligue 1,20-064,2005.0,0.1,1,1,0,0,1,1,1,100.0,0,0,0,0,1,2,0,0
1378,Maxence Lacroix,FRA,DF,Crystal Palace,eng  Premier League,24-339,2000.0,24.9,57,34,41,15,1,27,39,69.2,12,32,10,22,44,101,149,1
1379,Alban Lafont,FRA,GK,Nantes,fr  Ligue 1,26-047,1999.0,12.0,1,1,1,0,0,1,1,100.0,0,2,0,2,0,1,8,1
1380,Yoel Lago,ESP,DF,Celta Vigo,es  La Liga,20-351,2004.0,1.5,2,1,1,0,1,2,2,100.0,0,1,1,0,2,4,2,0
1381,Konrad Laimer,AUT,DF,Bayern Munich,de  Bundesliga,27-288,1997.0,11.7,27,14,10,14,3,12,34,35.3,22,15,1,14,6,33,14,1
1382,Stefan Lainer,AUT,DF,Gladbach,de  Bundesliga,32-196,1992.0,6.1,16,10,10,5,1,9,11,81.8,2,8,4,4,9,25,20,0
1383,Kenny Lala,MAD,DF,Brest,fr  Ligue 1,33-159,1991.0,21.8,54,35,29,21,4,31,47,66.0,16,21,9,12,20,74,57,0
1384,Adam Lallana,ENG,MF,Southampton,eng  Premier League,36-305,1988.0,4.0,8,5,4,4,0,2,12,16.7,10,4,1,3,5,13,5,0
1385,Mathis Lambourde,FRA,"FW,MF",Hellas Verona,it  Serie A,19-061,2006.0,0.6,3,1,2,1,0,1,3,33.3,2,2,0,2,0,3,1,0
1386,Mohamed Lamine Bayo,GUI,FW,Lille,fr  Ligue 1,26-280,1998.0,3.4,1,1,0,0,1,1,1,100.0,0,0,0,0,0,1,4,0
1387,Tariq Lamptey,GHA,DF,Brighton,eng  Premier League,24-162,2000.0,8.5,14,10,8,6,0,7,22,31.8,15,12,5,7,6,20,21,1
1388,Will Lankshear,ENG,"FW,MF",Tottenham,eng  Premier League,19-325,2005.0,0.1,0,0,0,0,0,0,0,,0,0,0,0,0,0,0,0
1389,Gianluca Lapadula,PER,"FW,MF",Cagliari,it  Serie A,35-032,1990.0,3.4,2,0,1,0,1,0,1,0.0,1,0,0,0,0,2,1,0
1390,Cyle Larin,CAN,FW,Mallorca,es  La Liga,29-328,1995.0,13.8,7,3,1,2,4,1,5,20.0,4,11,3,8,1,8,10,0
1391,Gautier Larsonneur,FRA,GK,Saint-Étienne,fr  Ligue 1,28-016,1997.0,25.0,1,0,1,0,0,0,1,0.0,1,1,0,1,0,1,19,0
1392,Hugo Larsson,SWE,MF,Eint Frankfurt,de  Bundesliga,20-257,2004.0,19.2,31,19,13,14,4,16,34,47.1,18,32,8,24,21,52,25,1
1393,Juanmi Latasa,ESP,FW,Valladolid,es  La Liga,23-353,2001.0,8.1,1,0,0,1,0,0,2,0.0,2,2,1,1,0,1,6,1
1394,Toni Lato,ESP,DF,Mallorca,es  La Liga,27-110,1997.0,4.0,9,6,2,3,4,4,6,66.7,2,4,0,4,3,12,19,0
1395,Roméo Lavia,BEL,MF,Chelsea,eng  Premier League,21-064,2004.0,5.9,17,10,5,9,3,7,14,50.0,7,6,0,6,11,28,5,0
1396,Valentino Lazaro,AUT,"DF,FW",Torino,it  Serie A,28-352,1996.0,21.4,25,11,10,12,3,15,27,55.6,12,26,5,21,9,34,38,1
1397,Darko Lazović,SRB,"DF,FW",Hellas Verona,it  Serie A,34-177,1990.0,15.5,19,9,5,12,2,10,26,38.5,16,19,3,16,11,30,39,0
1398,Manuel Lazzari,ITA,DF,Lazio,it  Serie A,31-102,1993.0,12.8,19,13,9,8,2,10,16,62.5,6,8,5,3,7,26,16,0
1399,Julien Le Cardinal,FRA,DF,Brest,fr  Ligue 1,27-220,1997.0,11.8,17,11,10,7,0,7,12,58.3,5,11,8,3,26,43,59,0
1400,Jérémy Le Douaron,FRA,FW,Brest,fr  Ligue 1,26-324,1998.0,1.1,1,0,0,0,1,0,1,0.0,1,1,0,1,0,1,0,0
1401,Enzo Le Fée,FRA,MF,Roma,it  Serie A,25-036,2000.0,3.5,7,4,5,2,0,2,6,33.3,4,9,3,6,5,12,2,0
1402,Robin Le Normand,ESP,DF,Atlético Madrid,es  La Liga,28-120,1996.0,15.3,19,12,16,3,0,8,15,53.3,7,12,6,6,6,25,71,1
1403,Nicola Leali,ITA,GK,Genoa,it  Serie A,32-022,1993.0,21.0,0,0,0,0,0,0,0,,0,0,0,0,0,0,11,1
1404,Rafael Leão,POR,FW,Milan,it  Serie A,25-274,1999.0,19.9,11,8,1,6,4,7,20,35.0,13,11,0,11,6,17,1,0
1405,Benjamin Lecomte,FRA,GK,Montpellier,fr  Ligue 1,33-319,1991.0,22.0,0,0,0,0,0,0,0,,0,0,0,0,0,0,14,1
1406,Pierre Lees-Melou,FRA,MF,Brest,fr  Ligue 1,31-290,1993.0,9.1,23,16,10,9,4,15,24,62.5,9,5,2,3,7,30,13,0
1407,Jordan Lefort,FRA,DF,Angers,fr  Ligue 1,31-214,1993.0,25.0,41,25,33,7,1,25,38,65.8,13,41,24,17,25,66,148,1
1408,Diogo Leite,POR,DF,Union Berlin,de  Bundesliga,26-047,1999.0,22.6,51,26,31,16,4,24,37,64.9,13,54,20,34,43,94,114,1
1409,Maxim Leitsch,GER,DF,Mainz 05,de  Bundesliga,26-297,1998.0,7.5,12,4,6,4,2,7,9,77.8,2,12,4,8,10,22,42,1
1410,Florian Lejeune,FRA,DF,Rayo Vallecano,es  La Liga,33-295,1991.0,26.9,31,21,18,11,2,14,31,45.2,17,27,22,5,21,52,130,0
1411,Stefan Lekovic,SRB,DF,Monza,it  Serie A,21-061,2004.0,3.5,8,4,5,2,1,4,9,44.4,5,4,4,0,6,14,3,0
1412,Iñigo Lekue,ESP,DF,Athletic Club,es  La Liga,31-311,1993.0,5.3,10,7,8,2,0,5,10,50.0,5,4,1,3,4,14,15,2
1413,Nunzio Lella,ITA,MF,Venezia,it  Serie A,24-226,2000.0,0.1,0,0,0,0,0,0,0,,0,0,0,0,0,0,0,0
1414,Thomas Lemar,FRA,MF,Atlético Madrid,es  La Liga,29-119,1995.0,0.4,1,1,1,0,0,1,3,33.3,2,0,0,0,0,1,0,0
1415,Félix Lemaréchal,FRA,"MF,FW",Strasbourg,fr  Ligue 1,21-216,2003.0,12.5,24,16,8,12,4,12,23,52.2,11,24,0,24,13,37,11,0
1416,Mario Lemina,GAB,"MF,DF",Wolves,eng  Premier League,31-191,1993.0,15.2,51,31,27,19,5,20,29,69.0,9,12,7,5,27,78,50,3
1417,Clément Lenglet,FRA,DF,Atlético Madrid,es  La Liga,29-267,1995.0,14.3,12,6,9,3,0,4,6,66.7,2,22,17,5,15,27,64,0
1418,Bernd Leno,GER,GK,Fulham,eng  Premier League,33-007,1992.0,28.0,2,2,2,0,0,2,2,100.0,0,1,0,1,0,2,7,4
1419,Donovan Léon,GUF,GK,Auxerre,fr  Ligue 1,32-128,1992.0,23.0,0,0,0,0,0,0,2,0.0,2,1,0,1,0,0,20,1
1420,Giovanni Leoni,ITA,DF,Parma,it  Serie A,18-080,2006.0,6.8,6,2,5,1,0,1,1,100.0,0,10,4,6,10,16,18,1
1421,Esteban Lepaul,FRA,FW,Angers,fr  Ligue 1,24-327,2000.0,9.4,5,2,0,2,3,2,10,20.0,8,10,1,9,2,7,6,0
1422,Johann Lepenant,FRA,MF,Nantes,fr  Ligue 1,22-140,2002.0,18.5,59,29,25,24,10,26,58,44.8,32,25,2,23,12,71,16,0
1423,Jefferson Lerma,COL,MF,Crystal Palace,eng  Premier League,30-137,1994.0,17.1,22,8,8,10,4,11,24,45.8,13,27,14,13,28,50,38,1
1424,Louis Leroux,FRA,"MF,DF",Nantes,fr  Ligue 1,19-047,2006.0,3.9,13,11,7,3,3,8,10,80.0,2,10,0,10,3,16,7,1
1425,Robert Lewandowski,POL,FW,Barcelona,es  La Liga,36-202,1988.0,22.3,7,3,1,4,2,3,8,37.5,5,10,2,8,3,10,22,0
1426,Jamie Leweling,GER,"MF,FW",Stuttgart,de  Bundesliga,24-013,2001.0,13.7,12,4,4,2,6,8,20,40.0,12,19,1,18,9,21,11,1
1427,Rico Lewis,ENG,"DF,MF",Manchester City,eng  Premier League,20-110,2004.0,17.9,26,16,11,11,4,11,17,64.7,6,24,5,19,11,37,38,1
1428,Keane Lewis-Potter,ENG,"DF,FW",Brentford,eng  Premier League,24-017,2001.0,25.3,36,22,19,13,4,23,36,63.9,13,22,8,14,12,48,53,1
1429,Myles Lewis-Skelly,ENG,DF,Arsenal,eng  Premier League,18-166,2006.0,7.5,19,13,10,9,0,8,8,100.0,0,0,0,0,5,24,11,0
1430,Ben Lhassine Kone,CIV,MF,Como,it  Serie A,24-362,2000.0,0.6,2,2,1,0,1,2,3,66.7,1,0,0,0,1,3,1,0
1431,Mattia Liberali,ITA,MF,Milan,it  Serie A,17-339,2007.0,0.7,2,1,0,1,1,2,2,100.0,0,0,0,0,0,2,0,0
1432,Philipp Lienhart,AUT,DF,Freiburg,de  Bundesliga,28-243,1996.0,22.0,19,12,11,8,0,13,28,46.4,15,22,13,9,29,48,74,2
1433,Matthijs de Ligt,NED,DF,Manchester Utd,eng  Premier League,25-211,1999.0,21.2,25,19,15,9,1,20,29,69.0,9,27,19,8,31,56,79,0
1434,Pedro Lima,BRA,DF,Wolves,eng  Premier League,18-253,2006.0,0.8,1,0,0,0,1,1,3,33.3,2,0,0,0,2,3,5,0
1435,Victor Lindelöf,SWE,DF,Manchester Utd,eng  Premier League,30-237,1994.0,1.7,3,0,3,0,0,1,1,100.0,0,1,0,1,3,6,14,1
1436,Jesper Lindstrøm,DEN,FW,Everton,eng  Premier League,25-010,2000.0,13.5,45,25,24,19,2,19,54,35.2,35,14,3,11,12,57,17,0
1437,Karol Linetty,POL,MF,Torino,it  Serie A,30-037,1995.0,14.2,33,21,14,17,2,16,32,50.0,16,14,5,9,12,45,22,1
1438,Samuel Lino,BRA,"MF,DF",Atlético Madrid,es  La Liga,25-078,1999.0,12.7,21,10,16,4,1,16,38,42.1,22,16,3,13,7,28,10,0
1439,Pol Lirola,ESP,DF,Marseille,fr  Ligue 1,27-210,1997.0,5.6,10,7,5,5,0,3,11,27.3,8,5,2,3,2,12,9,0
1440,Dailon Livramento,CPV,"FW,MF",Hellas Verona,it  Serie A,23-311,2001.0,8.7,12,8,1,5,6,6,12,50.0,6,9,2,7,2,14,7,0
1441,Valentino Livramento,ENG,DF,Newcastle Utd,eng  Premier League,22-119,2002.0,21.6,40,27,28,9,3,22,38,57.9,16,24,8,16,20,60,79,1
1442,Marin Ljubicic,CRO,"FW,MF",Union Berlin,de  Bundesliga,23-011,2002.0,1.2,0,0,0,0,0,0,0,,0,1,0,1,0,0,1,0
1443,Javier Llabrés,ESP,FW,Mallorca,es  La Liga,22-181,2002.0,0.6,0,0,0,0,0,0,0,,0,1,0,1,0,0,0,0
1444,Diego Llorente,ESP,DF,Betis,es  La Liga,31-207,1993.0,25.6,32,17,19,12,1,21,32,65.6,11,27,19,8,41,73,144,1
1445,Marcos Llorente,ESP,"DF,MF",Atlético Madrid,es  La Liga,30-040,1995.0,16.9,44,32,26,15,3,26,38,68.4,12,18,4,14,19,63,35,1
1446,Gautier Lloris,FRA,DF,Le Havre,fr  Ligue 1,29-236,1995.0,24.0,53,35,38,15,0,31,46,67.4,15,29,17,12,21,74,152,0
1447,Giovani Lo Celso,ARG,"MF,FW",Betis,es  La Liga,28-336,1996.0,11.5,29,18,6,14,9,16,23,69.6,7,11,1,10,5,34,3,1
1448,Stanislav Lobotka,SVK,MF,Napoli,it  Serie A,30-106,1994.0,22.7,39,26,12,17,10,17,25,68.0,8,22,6,16,20,59,45,1
1449,Manuel Locatelli,ITA,MF,Juventus,it  Serie A,27-062,1998.0,21.7,44,30,19,23,2,18,34,52.9,16,42,13,29,18,62,49,0
1450,Ruben Loftus-Cheek,ENG,MF,Milan,it  Serie A,29-047,1996.0,7.6,14,6,3,7,4,4,7,57.1,3,1,0,1,2,16,9,0
1451,Elysée Logbo,FRA,FW,Le Havre,fr  Ligue 1,20-309,2004.0,0.3,0,0,0,0,0,0,0,,0,0,0,0,0,0,0,0
1452,Enzo Loiodice,FRA,MF,Las Palmas,es  La Liga,24-104,2000.0,5.6,11,4,6,5,0,3,9,33.3,6,4,1,3,5,16,7,2
1453,Sean Longstaff,ENG,MF,Newcastle Utd,eng  Premier League,27-132,1997.0,8.3,27,16,10,9,8,18,26,69.2,8,15,4,11,6,33,5,0
1454,Ademola Lookman,NGA,"FW,MF",Atalanta,it  Serie A,27-142,1997.0,17.4,25,12,9,10,6,8,14,57.1,6,15,0,15,2,27,3,1
1455,Anthony Lopes,POR,GK,Nantes,fr  Ligue 1,34-161,1990.0,10.0,1,0,1,0,0,1,1,100.0,0,0,0,0,0,1,4,1
1456,David López,ESP,DF,Girona,es  La Liga,35-153,1989.0,21.8,26,18,18,5,3,16,29,55.2,13,20,10,10,12,38,88,1
1457,Diego López,ESP,"MF,FW",Valencia,es  La Liga,22-302,2002.0,21.4,21,13,5,12,4,12,36,33.3,24,18,0,18,10,31,8,0
1458,Fer López,nan,"FW,MF",Celta Vigo,es  La Liga,,,2.6,5,2,0,3,2,0,3,0.0,3,3,0,3,1,6,4,0
1459,Fermin López,ESP,"MF,FW",Barcelona,es  La Liga,21-304,2003.0,7.2,10,9,3,3,4,5,18,27.8,13,3,0,3,4,14,2,0
1460,Javi López,ESP,DF,Real Sociedad,es  La Liga,22-351,2002.0,16.2,29,16,15,11,3,15,27,55.6,12,19,6,13,4,33,41,1
1461,Pau López,ESP,GK,Girona,es  La Liga,30-088,1994.0,0.5,0,0,0,0,0,0,0,,0,0,0,0,0,0,1,0
1462,Roberto López,ESP,MF,Leganés,es  La Liga,24-321,2000.0,4.4,7,5,4,3,0,4,14,28.6,10,4,0,4,1,8,7,2
1463,Unai López,ESP,MF,Rayo Vallecano,es  La Liga,29-132,1995.0,12.5,19,12,9,5,5,10,22,45.5,12,12,2,10,19,38,12,0
1464,Iker Losada,ESP,"FW,MF",Celta Vigo,es  La Liga,23-222,2001.0,2.6,3,3,0,1,2,1,4,25.0,3,2,0,2,1,4,5,0
1465,Iker Losada,ESP,"MF,FW",Betis,es  La Liga,23-222,2001.0,3.7,10,7,2,4,4,5,10,50.0,5,2,0,2,3,13,2,0
1466,Anthony Losilla,FRA,MF,Bochum,de  Bundesliga,39-001,1986.0,12.0,28,16,14,11,3,16,32,50.0,16,21,7,14,18,46,25,1
1467,Jordan Lotomba,SUI,"MF,DF",Nice,fr  Ligue 1,26-163,1998.0,0.4,0,0,0,0,0,0,0,,0,0,0,0,0,0,1,0
1468,Tom Louchet,FRA,"DF,MF",Nice,fr  Ligue 1,21-311,2003.0,6.8,22,14,14,4,4,14,16,87.5,2,10,4,6,14,36,16,0
1469,Sandi Lovrić,SVN,MF,Udinese,it  Serie A,26-348,1998.0,20.4,41,25,22,15,4,19,39,48.7,20,31,4,27,20,61,19,0
1470,Pol Lozano,ESP,MF,Espanyol,es  La Liga,25-156,1999.0,15.7,43,27,17,22,4,20,44,45.5,24,23,4,19,18,61,20,0
1471,Lorenzo Lucca,ITA,FW,Udinese,it  Serie A,24-182,2000.0,21.0,9,6,2,2,5,4,9,44.4,5,13,1,12,5,14,23,0
1472,Jhon Lucumí,COL,DF,Bologna,it  Serie A,26-258,1998.0,20.9,31,18,18,13,0,16,26,61.5,10,25,12,13,17,48,64,3
1473,Yannik Lührs,GER,DF,Dortmund,de  Bundesliga,21-183,2003.0,1.4,1,1,1,0,0,0,0,,0,0,0,0,2,3,4,0
1474,José Luis Gayà,ESP,DF,Valencia,es  La Liga,29-290,1995.0,11.7,35,25,24,8,3,26,36,72.2,10,10,0,10,13,48,33,0
1475,José Luis Palomino,ARG,DF,Cagliari,it  Serie A,35-065,1990.0,4.3,8,5,2,4,2,4,6,66.7,2,6,4,2,7,15,14,0
1476,Douglas Luiz,BRA,MF,Juventus,it  Serie A,26-306,1998.0,5.4,12,8,7,4,1,6,9,66.7,3,4,1,3,2,14,4,0
1477,Romelu Lukaku,BEL,FW,Napoli,it  Serie A,31-302,1993.0,22.3,3,2,0,1,2,1,4,25.0,3,4,2,2,0,3,10,0
1478,Castello Lukeba,FRA,DF,RB Leipzig,de  Bundesliga,22-084,2002.0,11.3,24,11,11,10,3,10,13,76.9,3,17,8,9,11,35,46,0
1479,Dodi Lukebakio,BEL,FW,Sevilla,es  La Liga,27-168,1997.0,25.0,18,12,7,7,4,11,23,47.8,12,14,0,14,4,22,12,2
1480,Saša Lukić,SRB,MF,Fulham,eng  Premier League,28-210,1996.0,19.3,54,29,15,35,4,16,43,37.2,27,16,6,10,22,76,26,0
1481,Milos Lukovic,SRB,"FW,MF",Strasbourg,fr  Ligue 1,19-113,2005.0,0.1,0,0,0,0,0,0,0,,0,0,0,0,0,0,0,0
1482,Joe Lumley,ENG,GK,Southampton,eng  Premier League,30-024,1995.0,3.0,0,0,0,0,0,0,0,,0,0,0,0,0,0,3,3
1483,Daniel Luna,COL,MF,Mallorca,es  La Liga,21-308,2003.0,0.2,0,0,0,0,0,0,0,,0,1,0,1,0,0,0,0
1484,Andriy Lunin,UKR,GK,Real Madrid,es  La Liga,26-028,1999.0,4.0,0,0,0,0,0,0,0,,0,0,0,0,0,0,2,0
1485,Massimo Luongo,AUS,MF,Ipswich Town,eng  Premier League,32-167,1992.0,2.0,8,5,6,1,1,4,7,57.1,3,4,2,2,2,10,2,0
1486,Sebastiano Luperto,ITA,DF,Cagliari,it  Serie A,28-186,1996.0,28.0,39,19,26,12,1,13,21,61.9,8,23,13,10,24,63,127,1
1487,Zito Luvumbo,ANG,"FW,MF",Cagliari,it  Serie A,23-002,2002.0,12.3,6,3,1,3,2,2,11,18.2,9,4,0,4,1,7,4,0
1488,Charalambos Lykogiannis,GRE,DF,Bologna,it  Serie A,31-140,1993.0,9.6,16,10,10,5,1,7,13,53.8,6,6,4,2,9,25,31,1
1489,Senne Lynen,BEL,MF,Werder Bremen,de  Bundesliga,26-020,1999.0,21.9,59,29,29,24,6,32,56,57.1,24,47,12,35,46,105,52,5
1490,Mathias Løvik,NOR,"DF,FW",Parma,it  Serie A,21-095,2003.0,0.9,0,0,0,0,0,0,1,0.0,1,1,1,0,2,2,3,0
1491,Othmane Maamma,MAR,"FW,MF",Montpellier,fr  Ligue 1,19-156,2005.0,1.9,2,1,1,1,0,0,3,0.0,3,3,0,3,1,3,2,1
1492,Ian Maatsen,NED,DF,Aston Villa,eng  Premier League,23-001,2002.0,6.9,15,8,7,6,2,8,14,57.1,6,5,0,5,9,24,23,2
1493,Alexis Mac Allister,ARG,MF,Liverpool,eng  Premier League,26-077,1998.0,23.5,77,48,22,45,10,45,84,53.6,39,52,5,47,19,96,24,1
1494,Deiver Machado,COL,DF,Lens,fr  Ligue 1,31-190,1993.0,14.1,29,21,12,12,5,15,25,60.0,10,16,3,13,12,41,20,0
1495,Shuto Machino,JPN,"FW,MF",Holstein Kiel,de  Bundesliga,25-162,1999.0,14.7,7,4,4,2,1,5,10,50.0,5,8,1,7,6,13,15,0
1496,Darwin Machís,VEN,"FW,MF",Valladolid,es  La Liga,32-032,1993.0,4.7,4,3,2,2,0,2,6,33.3,4,3,0,3,3,7,7,0
1497,Yvann Macon,FRA,DF,Saint-Étienne,fr  Ligue 1,26-161,1998.0,5.8,11,6,4,4,3,4,12,33.3,8,10,3,7,1,12,9,1
1498,James Maddison,ENG,MF,Tottenham,eng  Premier League,28-108,1996.0,16.7,27,16,7,13,7,9,26,34.6,17,13,3,10,11,38,17,1
1499,Eros Maddy,NED,DF,Auxerre,fr  Ligue 1,24-034,2001.0,0.1,0,0,0,0,0,0,0,,0,0,0,0,0,0,0,0
1500,Noni Madueke,ENG,FW,Chelsea,eng  Premier League,23-001,2002.0,16.1,16,11,7,8,1,11,29,37.9,18,11,0,11,7,23,9,0
1501,Pablo Maffeo,ESP,DF,Mallorca,es  La Liga,27-242,1997.0,18.6,45,27,34,9,2,25,36,69.4,11,25,10,15,20,65,69,1
1502,Gabriel Magalhães,BRA,DF,Arsenal,eng  Premier League,27-082,1997.0,25.1,24,14,12,7,5,12,16,75.0,4,40,28,12,15,39,87,2
1503,Soungoutou Magassa,FRA,MF,Monaco,fr  Ligue 1,21-154,2003.0,9.8,40,23,12,24,4,22,38,57.9,16,12,3,9,21,61,18,1
1504,Edmond-Paris Maghoma,ENG,"MF,FW",Brentford,eng  Premier League,23-307,2001.0,1.2,2,1,0,2,0,1,3,33.3,2,2,2,0,1,3,2,0
1505,Giangiacomo Magnani,ITA,DF,Hellas Verona,it  Serie A,29-158,1995.0,11.8,20,15,14,6,0,7,7,100.0,0,16,9,7,17,37,73,1
1506,Hugo Magnetti,FRA,MF,Brest,fr  Ligue 1,26-285,1998.0,19.7,39,25,15,22,2,17,38,44.7,21,15,3,12,14,53,27,0
1507,Frank Magri,CMR,FW,Toulouse,fr  Ligue 1,25-188,1999.0,9.4,4,0,0,3,1,3,7,42.9,4,13,1,12,2,6,5,0
1508,Harry Maguire,ENG,DF,Manchester Utd,eng  Premier League,32-006,1993.0,15.1,24,13,18,5,1,11,15,73.3,4,13,11,2,35,59,66,1
1509,Jon Magunazelaia,ESP,MF,Real Sociedad,es  La Liga,24-241,2000.0,0.1,1,1,1,0,0,0,0,,0,0,0,0,0,1,0,0
1510,Arne Maier,GER,MF,Augsburg,de  Bundesliga,26-062,1999.0,9.1,12,6,4,8,0,7,12,58.3,5,14,1,13,4,16,12,1
1511,Mike Maignan,FRA,GK,Milan,it  Serie A,29-251,1995.0,27.0,0,0,0,0,0,0,1,0.0,1,1,0,1,0,0,15,3
1512,Patrick Mainka,GER,DF,Heidenheim,de  Bundesliga,30-125,1994.0,25.0,48,24,29,17,2,29,45,64.4,16,43,23,20,52,100,143,0
1513,Kobbie Mainoo,ENG,MF,Manchester Utd,eng  Premier League,19-326,2005.0,14.3,37,24,15,11,11,20,33,60.6,13,15,2,13,17,54,6,1
1514,Ainsley Maitland-Niles,ENG,"DF,MF",Lyon,fr  Ligue 1,27-194,1997.0,14.5,43,27,19,14,10,30,48,62.5,18,21,3,18,19,62,40,6
1515,Radosław Majecki,POL,GK,Monaco,fr  Ligue 1,25-115,1999.0,15.0,0,0,0,0,0,0,2,0.0,2,0,0,0,0,0,8,1
1516,Lovro Majer,CRO,MF,Wolfsburg,de  Bundesliga,27-053,1998.0,1.6,0,0,0,0,0,0,2,0.0,2,2,0,2,0,0,1,0
1517,Jordy Makengo,FRA,DF,Freiburg,de  Bundesliga,23-220,2001.0,2.3,11,6,7,3,1,7,8,87.5,1,3,1,2,3,14,9,0
1518,Antoine Makoumbou,CGO,MF,Cagliari,it  Serie A,26-236,1998.0,18.4,34,18,24,8,2,18,23,78.3,5,22,4,18,12,46,20,0
1519,Nikola Maksimović,SRB,DF,Montpellier,fr  Ligue 1,33-106,1991.0,6.5,9,5,6,3,0,6,7,85.7,1,5,4,1,6,15,30,1
1520,Tyrell Malacia,NED,DF,Manchester Utd,eng  Premier League,25-206,1999.0,1.1,2,1,2,0,0,1,2,50.0,1,0,0,0,1,3,1,1
1521,Jarzinho Malanga,GER,DF,Stuttgart,de  Bundesliga,18-244,2006.0,0.0,0,0,0,0,0,0,0,,0,0,0,0,0,0,0,0
1522,Julián Malatini,ARG,DF,Werder Bremen,de  Bundesliga,23-284,2001.0,5.0,11,9,5,5,1,5,11,45.5,6,8,3,5,7,18,17,0
1523,Daniel Maldini,ITA,"MF,FW",Monza,it  Serie A,23-151,2001.0,14.5,14,6,5,9,0,6,13,46.2,7,8,2,6,4,18,12,2
1524,Daniel Maldini,ITA,"FW,MF",Atalanta,it  Serie A,23-151,2001.0,0.3,0,0,0,0,0,0,0,,0,0,0,0,0,0,0,0
1525,Youssef Maleh,MAR,MF,Empoli,it  Serie A,26-201,1998.0,16.8,45,23,17,23,5,17,34,50.0,17,25,6,19,16,61,25,0
1526,Donyell Malen,NED,FW,Aston Villa,eng  Premier League,26-061,1999.0,1.9,5,2,3,1,1,1,2,50.0,1,0,0,0,0,5,0,0
1527,Donyell Malen,NED,"FW,MF",Dortmund,de  Bundesliga,26-061,1999.0,6.8,0,0,0,0,0,0,2,0.0,2,2,0,2,3,3,6,0
1528,Ruslan Malinovskyi,UKR,"MF,FW",Genoa,it  Serie A,31-311,1993.0,2.7,8,6,2,5,1,2,3,66.7,1,1,0,1,1,9,4,0
1529,Lennard Maloney,USA,MF,Heidenheim,de  Bundesliga,25-154,1999.0,8.4,20,11,12,7,1,14,23,60.9,9,9,2,7,14,34,38,0
1530,Lennard Maloney,USA,MF,Mainz 05,de  Bundesliga,25-154,1999.0,0.3,1,0,0,0,1,1,1,100.0,0,1,0,1,0,1,3,0
1531,Aaron Malouda,FRA,FW,Lille,fr  Ligue 1,19-101,2005.0,0.0,0,0,0,0,0,0,0,,0,0,0,0,0,0,0,0
1532,Giorgi Mamardashvili,GEO,GK,Valencia,es  La Liga,24-163,2000.0,23.0,0,0,0,0,0,0,1,0.0,1,0,0,0,1,1,9,3
1533,Dennis Man,ROU,"FW,MF",Parma,it  Serie A,26-197,1998.0,19.5,11,5,5,3,3,5,21,23.8,16,11,3,8,8,19,9,0
1534,Hianga Mananga Mbock,FRA,MF,Brest,fr  Ligue 1,25-073,1999.0,0.2,0,0,0,0,0,0,0,,0,0,0,0,1,1,0,0
1535,Gianluca Mancini,ITA,DF,Roma,it  Serie A,28-328,1996.0,24.9,29,17,17,10,2,15,25,60.0,10,17,12,5,29,58,62,0
1536,Steve Mandanda,FRA,GK,Rennes,fr  Ligue 1,39-348,1985.0,16.5,0,0,0,0,0,0,1,0.0,1,0,0,0,0,0,6,2
1537,Christos Mandas,GRE,GK,Lazio,it  Serie A,23-175,2001.0,1.0,0,0,0,0,0,0,0,,0,0,0,0,0,0,3,0
1538,Reinildo Mandava,MOZ,DF,Atlético Madrid,es  La Liga,31-049,1994.0,9.3,17,11,9,7,1,9,16,56.3,7,9,5,4,16,33,32,0
1539,Aïssa Mandi,ALG,DF,Lille,fr  Ligue 1,33-140,1991.0,14.1,19,12,4,12,3,10,15,66.7,5,20,9,11,11,30,33,0
1540,Rolando Mandragora,ITA,MF,Fiorentina,it  Serie A,27-255,1997.0,11.8,12,5,6,5,1,6,17,35.3,11,16,5,11,11,23,34,1
1541,Orel Mangala,BEL,MF,Everton,eng  Premier League,26-358,1998.0,14.0,16,8,3,11,2,5,8,62.5,3,8,3,5,21,37,24,1
1542,Orel Mangala,BEL,MF,Lyon,fr  Ligue 1,26-358,1998.0,0.7,1,0,0,0,1,0,1,0.0,1,2,0,2,0,1,1,0
1543,Ryan Manning,IRL,DF,Southampton,eng  Premier League,28-270,1996.0,9.8,23,16,13,8,2,12,20,60.0,8,16,10,6,13,36,26,0
1544,Javier Manquillo,ESP,DF,Celta Vigo,es  La Liga,30-310,1994.0,5.7,7,5,4,3,0,2,10,20.0,8,5,3,2,7,14,14,0
1545,Johan Manzambi,SUI,"MF,FW",Freiburg,de  Bundesliga,19-148,2005.0,0.4,1,0,0,1,0,0,0,,0,1,0,1,0,1,2,0
1546,Alberto Manzoni,ITA,MF,Atalanta,it  Serie A,19-259,2005.0,0.1,0,0,0,0,0,0,0,,0,0,0,0,0,0,0,0
1547,Sekou Mara,FRA,"FW,MF",Strasbourg,fr  Ligue 1,22-224,2002.0,7.1,9,6,0,5,4,3,8,37.5,5,7,0,7,3,12,2,0
1548,Alessandro Marcandalli,ITA,DF,Genoa,it  Serie A,22-167,2002.0,0.5,1,0,1,0,0,0,0,,0,0,0,0,0,1,2,0
1549,Alessandro Marcandalli,ITA,DF,Venezia,it  Serie A,22-167,2002.0,1.3,3,2,2,1,0,1,2,50.0,1,1,0,1,1,4,10,0
1550,Marcão,BRA,DF,Sevilla,es  La Liga,28-279,1996.0,5.1,9,6,6,3,0,2,3,66.7,1,9,6,3,6,15,27,1
1551,Solly March,ENG,"MF,FW",Brighton,eng  Premier League,30-234,1994.0,0.5,5,3,2,2,1,4,5,80.0,1,2,0,2,1,6,0,0
1552,Filip Marchwiński,POL,MF,Lecce,it  Serie A,23-060,2002.0,0.2,0,0,0,0,0,0,0,,0,0,0,0,0,0,0,0
1553,Óscar de Marcos,ESP,DF,Athletic Club,es  La Liga,35-331,1989.0,13.7,27,13,13,11,3,18,31,58.1,13,13,1,12,13,40,27,0
1554,Alberto Marí,ESP,FW,Valencia,es  La Liga,23-243,2001.0,0.1,0,0,0,0,0,0,0,,0,0,0,0,0,0,0,0
1555,Pablo Marí,ESP,DF,Monza,it  Serie A,31-192,1993.0,18.1,26,15,14,12,0,11,21,52.4,10,24,21,3,37,63,85,2
1556,Pablo Marí,ESP,DF,Fiorentina,it  Serie A,31-192,1993.0,2.2,1,1,1,0,0,0,0,,0,1,0,1,2,3,18,0
1557,José María Giménez,URU,DF,Atlético Madrid,es  La Liga,30-050,1995.0,17.4,20,13,13,7,0,14,24,58.3,10,23,16,7,21,41,91,1
1558,Luca Marianucci,ITA,DF,Empoli,it  Serie A,20-231,2004.0,4.4,16,6,9,7,0,7,12,58.3,5,5,1,4,5,21,21,1
1559,Mirko Marić,CRO,"FW,MF",Monza,it  Serie A,29-299,1995.0,1.2,1,0,1,0,0,1,2,50.0,1,1,1,0,1,2,1,0
1560,Mirko Marić,CRO,FW,Venezia,it  Serie A,29-299,1995.0,3.1,2,2,2,0,0,0,3,0.0,3,2,0,2,1,3,10,0
1561,Arkaitz Mariezkurrena,ESP,"MF,FW",Real Sociedad,es  La Liga,19-340,2005.0,0.5,1,0,1,0,0,0,2,0.0,2,0,0,0,1,2,1,0
1562,Rafa Marín,ESP,DF,Napoli,it  Serie A,22-296,2002.0,0.1,0,0,0,0,0,0,0,,0,0,0,0,0,0,0,0
1563,Pablo Marín,ESP,MF,Real Sociedad,es  La Liga,21-251,2003.0,5.2,11,7,2,8,1,5,10,50.0,5,5,2,3,2,13,8,0
1564,Răzvan Marin,ROU,MF,Cagliari,it  Serie A,28-292,1996.0,12.5,20,12,8,10,2,12,23,52.2,11,4,0,4,2,22,15,2
1565,Guillermo Maripán,CHI,DF,Torino,it  Serie A,30-309,1994.0,16.0,26,13,15,10,1,15,23,65.2,8,20,10,10,22,48,74,1
1566,Mika Màrmol,ESP,DF,Las Palmas,es  La Liga,22-252,2002.0,17.2,38,15,21,15,2,22,33,66.7,11,31,12,19,27,65,74,1
1567,Omar Marmoush,EGY,"MF,FW",Manchester City,eng  Premier League,26-032,1999.0,4.3,6,4,2,2,2,5,10,50.0,5,5,0,5,3,9,2,0
1568,Omar Marmoush,EGY,FW,Eint Frankfurt,de  Bundesliga,26-032,1999.0,16.1,12,8,0,3,9,3,7,42.9,4,7,1,6,2,14,2,0
1569,Mario Maroto,ESP,MF,Valladolid,es  La Liga,21-103,2003.0,0.2,0,0,0,0,0,0,1,0.0,1,0,0,0,2,2,1,0
1570,Marquinhos,BRA,DF,Paris S-G,fr  Ligue 1,30-301,1994.0,15.6,24,14,7,13,4,20,25,80.0,5,20,11,9,9,33,55,0
1571,Unai Marrero,ESP,GK,Real Sociedad,es  La Liga,23-153,2001.0,1.0,0,0,0,0,0,0,0,,0,0,0,0,0,0,1,0
1572,Ange Martial Tia,MLI,MF,Reims,fr  Ligue 1,18-111,2006.0,0.0,1,1,0,1,0,1,2,50.0,1,0,0,0,0,1,0,0
1573,Aarón Martín,ESP,DF,Genoa,it  Serie A,27-323,1997.0,26.2,60,39,34,22,4,27,39,69.2,12,28,9,19,16,76,57,1
1574,Carlos Martín,ESP,"FW,MF",Alavés,es  La Liga,22-323,2002.0,11.0,29,16,12,11,6,10,35,28.6,25,23,1,22,5,34,14,0
1575,Gerard Martín,ESP,DF,Barcelona,es  La Liga,23-069,2002.0,5.8,14,6,7,4,3,9,14,64.3,5,10,2,8,7,21,14,0
1576,Iván Martín,ESP,MF,Girona,es  La Liga,26-025,1999.0,18.1,25,14,13,10,2,11,28,39.3,17,15,3,12,10,35,14,1
1577,Jon Martin,ESP,DF,Real Sociedad,es  La Liga,19-069,2006.0,3.3,1,1,0,0,1,1,1,100.0,0,6,5,1,5,6,15,0
1578,Jonas Martin,FRA,MF,Brest,fr  Ligue 1,34-336,1990.0,5.1,11,5,8,2,1,5,10,50.0,5,3,0,3,6,17,11,1
1579,Mario Martín,ESP,MF,Valladolid,es  La Liga,21-006,2004.0,15.1,45,23,21,21,3,15,38,39.5,23,22,4,18,18,63,36,6
1580,Gabriel Martinelli,BRA,"FW,MF",Arsenal,eng  Premier League,23-266,2001.0,16.6,17,13,6,4,7,6,20,30.0,14,9,0,9,2,19,13,0
1581,Arnau Martinez,ESP,"DF,MF",Girona,es  La Liga,21-320,2003.0,20.8,34,17,21,9,4,23,41,56.1,18,11,5,6,19,53,55,2
1582,Emiliano Martínez,ARG,GK,Aston Villa,eng  Premier League,32-190,1992.0,27.0,2,2,2,0,0,1,1,100.0,0,1,0,1,0,2,13,6
1583,Iñigo Martínez,ESP,DF,Barcelona,es  La Liga,33-298,1991.0,19.8,17,10,14,3,0,10,12,83.3,2,15,6,9,17,34,73,1
1584,Javi Martínez,ESP,MF,Osasuna,es  La Liga,25-079,1999.0,0.1,0,0,0,0,0,0,0,,0,0,0,0,0,0,0,0
1585,Josep Martinez,ESP,GK,Inter,it  Serie A,26-288,1998.0,3.0,0,0,0,0,0,0,0,,0,0,0,0,0,0,0,0
1586,Lautaro Martínez,ARG,FW,Inter,it  Serie A,27-201,1997.0,24.1,25,15,10,7,8,11,21,52.4,10,16,2,14,9,34,14,0
1587,Lisandro Martínez,ARG,DF,Manchester Utd,eng  Premier League,27-052,1998.0,19.5,40,24,25,12,3,21,36,58.3,15,22,8,14,32,72,57,1
1588,Lucas Martínez Quarta,ARG,DF,Fiorentina,it  Serie A,28-305,1996.0,3.9,12,7,9,3,0,8,13,61.5,5,5,2,3,3,15,25,1
1589,Ramón Martínez,ESP,DF,Sevilla,es  La Liga,22-140,2002.0,0.1,0,0,0,0,0,0,0,,0,0,0,0,0,0,0,0
1590,Toni Martínez,ESP,FW,Alavés,es  La Liga,27-254,1997.0,8.6,9,5,3,3,3,2,3,66.7,1,7,2,5,0,9,9,0
1591,Kevin Martins,ITA,"MF,DF",Monza,it  Serie A,20-039,2005.0,2.0,5,4,3,2,0,3,6,50.0,3,1,0,1,1,6,4,1
1592,Javi Martón,ESP,"FW,MF",Athletic Club,es  La Liga,25-309,1999.0,0.6,0,0,0,0,0,0,0,,0,0,0,0,0,0,0,0
1593,Adam Marušić,MNE,DF,Lazio,it  Serie A,32-145,1992.0,18.3,25,16,13,10,2,14,22,63.6,8,11,6,5,11,36,44,0
1594,Marvin,ESP,"DF,FW",Las Palmas,es  La Liga,24-251,2000.0,6.3,15,7,8,4,3,5,17,29.4,12,9,3,6,5,20,16,0
1595,Omar Mascarell,EQG,MF,Mallorca,es  La Liga,32-037,1993.0,16.5,23,12,11,12,0,12,27,44.4,15,24,15,9,35,58,47,2
1596,Adam Masina,MAR,DF,Torino,it  Serie A,31-068,1994.0,16.1,28,14,20,7,1,20,35,57.1,15,23,14,9,18,46,63,2
1597,Patrizio Masini,ITA,MF,Genoa,it  Serie A,24-043,2001.0,7.6,30,16,13,13,4,8,16,50.0,8,11,3,8,8,38,21,0
1598,Giorgos Masouras,GRE,"FW,MF",Bochum,de  Bundesliga,31-069,1994.0,4.6,10,6,2,5,3,5,9,55.6,4,7,1,6,1,11,0,0
1599,Erhan Mašović,SRB,DF,Bochum,de  Bundesliga,26-109,1998.0,9.5,13,10,10,3,0,12,26,46.2,14,17,11,6,12,25,50,0
1600,Han-Noah Massengo,FRA,MF,Auxerre,fr  Ligue 1,23-247,2001.0,5.2,10,7,4,4,2,6,8,75.0,2,5,2,3,9,19,4,1
1601,Clinton Mata,ANG,DF,Lyon,fr  Ligue 1,32-124,1992.0,21.1,36,24,22,11,3,24,31,77.4,7,23,15,8,36,72,61,2
1602,Jaime Mata,ESP,FW,Las Palmas,es  La Liga,36-138,1988.0,5.2,6,1,1,5,0,3,9,33.3,6,4,1,3,3,9,8,0
1603,Igor Matanovic,CRO,FW,Eint Frankfurt,de  Bundesliga,21-345,2003.0,3.4,2,0,0,2,0,0,1,0.0,1,2,0,2,1,3,9,0
1604,Pape Matar Sarr,SEN,MF,Tottenham,eng  Premier League,22-178,2002.0,15.5,39,28,16,20,3,10,20,50.0,10,21,7,14,22,61,17,1
1605,Eliot Matazo,BEL,MF,Monaco,fr  Ligue 1,23-024,2002.0,0.8,3,2,0,3,0,0,0,,0,0,0,0,1,4,2,0
1606,Jean-Philippe Mateta,FRA,FW,Crystal Palace,eng  Premier League,27-256,1997.0,23.7,14,10,4,8,2,3,14,21.4,11,14,3,11,2,16,20,0
1607,Nemanja Matić,SRB,MF,Lyon,fr  Ligue 1,36-222,1988.0,17.5,31,26,9,17,5,17,31,54.8,14,18,7,11,12,43,23,1
1608,Chrislain Matsima,FRA,DF,Augsburg,de  Bundesliga,22-300,2002.0,19.3,15,11,8,6,1,8,15,53.3,7,35,21,14,39,54,114,0
1609,Jean Mattéo Bahoya,FRA,"MF,FW",Eint Frankfurt,de  Bundesliga,19-308,2005.0,4.4,15,10,8,5,2,9,18,50.0,9,2,0,2,4,19,4,1
1610,Alan Matturro,URU,DF,Genoa,it  Serie A,20-151,2004.0,8.5,10,5,5,5,0,3,14,21.4,11,6,2,4,12,22,33,0
1611,Azor Matusiwa,NED,MF,Rennes,fr  Ligue 1,26-317,1998.0,16.7,52,31,23,27,2,25,33,75.8,8,22,7,15,28,80,38,0
1612,Neal Maupay,FRA,FW,Marseille,fr  Ligue 1,28-209,1996.0,10.2,7,3,1,5,1,3,5,60.0,2,4,0,4,2,9,0,0
1613,Maurides,BRA,FW,St. Pauli,de  Bundesliga,31-001,1994.0,0.0,0,0,0,0,0,0,0,,0,0,0,0,0,0,0,0
1614,Stephy Mavididi,ENG,FW,Leicester City,eng  Premier League,26-284,1998.0,15.4,29,15,15,9,5,10,34,29.4,24,22,2,20,10,39,12,0
1615,Konstantinos Mavropanos,GRE,DF,West Ham,eng  Premier League,27-090,1997.0,17.5,30,21,20,9,1,13,24,54.2,11,19,14,5,33,63,92,1
1616,Christian Mawissa,FRA,DF,Monaco,fr  Ligue 1,19-327,2005.0,11.5,34,24,22,10,2,22,36,61.1,14,20,4,16,23,57,33,1
1617,Keke Maximilian Topp,GER,"FW,MF",Werder Bremen,de  Bundesliga,20-351,2004.0,2.4,2,1,0,1,1,1,2,50.0,1,0,0,0,1,3,1,0
1618,Borja Mayoral,ESP,FW,Getafe,es  La Liga,27-340,1997.0,5.7,1,1,1,0,0,0,3,0.0,3,3,0,3,0,1,5,0
1619,Senny Mayulu,FRA,MF,Paris S-G,fr  Ligue 1,18-298,2006.0,5.2,17,10,7,9,1,5,9,55.6,4,7,3,4,3,20,5,0
1620,Noussair Mazraoui,MAR,DF,Manchester Utd,eng  Premier League,27-117,1997.0,23.6,81,47,38,31,12,41,70,58.6,29,26,7,19,29,110,69,0
1621,Luca Mazzitelli,ITA,MF,Como,it  Serie A,29-116,1995.0,3.7,9,6,4,5,0,5,7,71.4,2,5,2,3,3,12,10,0
1622,Pasquale Mazzocchi,ITA,"DF,FW",Napoli,it  Serie A,29-227,1995.0,6.8,11,6,7,1,3,5,12,41.7,7,4,1,3,4,15,18,0
1623,Samuel Mbangula,BEL,FW,Juventus,it  Serie A,21-054,2004.0,7.8,15,10,7,6,2,7,13,53.8,6,7,0,7,3,18,3,0
1624,Ethan Mbappé,FRA,"MF,FW",Lille,fr  Ligue 1,18-072,2006.0,2.2,6,2,3,2,1,0,3,0.0,3,5,0,5,1,7,0,0
1625,Kylian Mbappé,FRA,FW,Real Madrid,es  La Liga,26-081,1998.0,23.9,8,5,1,3,4,1,5,20.0,4,3,0,3,0,8,1,0
1626,Ibrahim Mbaye,FRA,"FW,MF",Paris S-G,fr  Ligue 1,17-046,2008.0,1.0,0,0,0,0,0,0,3,0.0,3,0,0,0,0,0,0,0
1627,Bryan Mbeumo,CMR,FW,Brentford,eng  Premier League,25-216,1999.0,27.9,34,20,13,11,10,13,20,65.0,7,20,3,17,12,46,40,0
1628,James Mcatee,ENG,"MF,FW",Manchester City,eng  Premier League,22-144,2002.0,1.4,3,2,0,3,0,0,3,0.0,3,4,0,4,1,4,0,0
1629,Kasey McAteer,IRL,"FW,MF",Leicester City,eng  Premier League,23-109,2001.0,4.3,11,8,6,4,1,6,14,42.9,8,8,1,7,2,13,10,0
1630,Oliver McBurnie,SCO,FW,Las Palmas,es  La Liga,28-280,1996.0,11.8,9,5,4,4,1,4,10,40.0,6,7,3,4,4,13,14,0
1631,Alex McCarthy,ENG,GK,Southampton,eng  Premier League,35-098,1989.0,5.0,0,0,0,0,0,0,0,,0,0,0,0,0,0,1,4
1632,John McGinn,SCO,"MF,FW",Aston Villa,eng  Premier League,30-144,1994.0,19.7,27,18,8,13,6,10,21,47.6,11,14,0,14,11,38,11,3
1633,Scott McKenna,SCO,DF,Las Palmas,es  La Liga,28-119,1996.0,19.4,14,9,10,4,0,7,9,77.8,2,32,24,8,8,22,114,2
1634,Weston McKennie,USA,"MF,DF",Juventus,it  Serie A,26-195,1998.0,17.3,21,8,10,9,2,8,15,53.3,7,17,5,12,12,33,23,0
1635,Mark McKenzie,USA,DF,Toulouse,fr  Ligue 1,26-014,1999.0,21.4,43,25,27,15,1,26,34,76.5,8,21,14,7,15,58,102,1
1636,Dwight McNeil,ENG,"MF,FW",Everton,eng  Premier League,25-109,1999.0,12.7,10,6,5,3,2,7,16,43.8,9,7,0,7,5,15,1,1
1637,Scott McTominay,SCO,MF,Manchester Utd,eng  Premier League,28-093,1996.0,0.2,0,0,0,0,0,0,1,0.0,1,0,0,0,0,0,1,0
1638,Scott McTominay,SCO,MF,Napoli,it  Serie A,28-093,1996.0,23.9,33,19,10,20,3,17,33,51.5,16,14,4,10,19,52,32,0
1639,Jakov Medić,CRO,DF,Bochum,de  Bundesliga,26-185,1998.0,13.9,10,8,7,2,1,5,11,45.5,6,28,19,9,16,26,84,3
1640,Facundo Medina,ARG,DF,Lens,fr  Ligue 1,25-287,1999.0,20.3,37,25,17,16,4,18,30,60.0,12,22,8,14,25,62,46,0
1641,Ben Mee,ENG,DF,Brentford,eng  Premier League,35-171,1989.0,2.0,2,2,0,2,0,1,1,100.0,0,3,3,0,4,6,7,0
1642,Jayden Meghoma,ENG,DF,Brentford,eng  Premier League,18-256,2006.0,0.1,0,0,0,0,0,0,0,,0,0,0,0,0,0,0,0
1643,Henrik Meister,DEN,FW,Rennes,fr  Ligue 1,21-114,2003.0,0.7,2,0,0,2,0,0,0,,0,4,0,4,1,3,0,0
1644,Bamo Meïté,CIV,DF,Montpellier,fr  Ligue 1,23-098,2001.0,2.8,2,1,1,1,0,1,2,50.0,1,1,1,0,2,4,7,2
1645,Bamo Meïté,CIV,"DF,MF",Marseille,fr  Ligue 1,23-098,2001.0,0.3,0,0,0,0,0,0,0,,0,0,0,0,0,0,1,0
1646,Mohamed Meité,FRA,FW,Rennes,fr  Ligue 1,17-151,2007.0,1.4,0,0,0,0,0,0,0,,0,0,0,0,0,0,1,0
1647,Mateo Mejía,ESP,FW,Sevilla,es  La Liga,21-345,2003.0,0.1,0,0,0,0,0,0,0,,0,0,0,0,0,0,0,0
1648,Farid El Melali,ALG,FW,Angers,fr  Ligue 1,27-310,1997.0,17.0,25,13,13,6,6,10,29,34.5,19,14,1,13,12,37,12,1
1649,Filippo Melegoni,ITA,"MF,FW",Genoa,it  Serie A,26-021,1999.0,1.0,1,1,1,0,0,0,4,0.0,4,0,0,0,0,1,2,0
1650,Arthur Melo,BRA,MF,Girona,es  La Liga,28-211,1996.0,1.8,9,5,3,6,0,5,8,62.5,3,2,0,2,1,10,2,0
1651,Nuno Mendes,POR,DF,Paris S-G,fr  Ligue 1,22-265,2002.0,14.0,22,14,10,10,2,17,29,58.6,12,19,7,12,15,37,27,0
1652,Brais Méndez,ESP,MF,Real Sociedad,es  La Liga,28-063,1997.0,14.0,18,11,5,9,4,7,21,33.3,14,10,1,9,6,24,16,1
1653,Antoine Mendy,FRA,DF,Nice,fr  Ligue 1,20-288,2004.0,6.0,24,17,12,12,0,16,23,69.6,7,7,3,4,5,29,22,0
1654,Ferland Mendy,FRA,DF,Real Madrid,es  La Liga,29-276,1995.0,11.2,17,14,7,6,4,9,12,75.0,3,11,4,7,9,26,8,1
1655,Nampalys Mendy,SEN,MF,Lens,fr  Ligue 1,32-261,1992.0,2.1,7,5,3,3,1,4,9,44.4,5,4,2,2,3,10,2,0
1656,Gideon Mensah,GHA,DF,Auxerre,fr  Ligue 1,26-236,1998.0,18.9,51,31,26,19,6,23,48,47.9,25,20,3,17,40,91,61,0
1657,Alex Meret,ITA,GK,Napoli,it  Serie A,27-354,1997.0,24.4,0,0,0,0,0,0,0,,0,1,0,1,0,0,13,0
1658,Mikel Merino,ESP,"MF,FW",Arsenal,eng  Premier League,28-262,1996.0,11.8,25,15,5,13,7,9,21,42.9,12,17,5,12,12,37,18,1
1659,Quentin Merlin,FRA,DF,Marseille,fr  Ligue 1,22-299,2002.0,13.4,17,13,10,3,4,5,11,45.5,6,18,4,14,12,29,14,1
1660,Víctor Meseguer,ESP,MF,Valladolid,es  La Liga,25-275,1999.0,4.6,10,6,4,4,2,2,10,20.0,8,3,0,3,2,12,4,1
1661,Rafik Messali,FRA,DF,Toulouse,fr  Ligue 1,21-317,2003.0,3.2,13,6,5,6,2,5,6,83.3,1,6,1,5,4,17,6,0
1662,Junior Messias,BRA,"MF,FW",Genoa,it  Serie A,33-302,1991.0,6.0,8,5,4,4,0,2,6,33.3,4,2,1,1,5,13,10,0
1663,Connor Metcalfe,AUS,MF,St. Pauli,de  Bundesliga,25-126,1999.0,2.5,1,0,0,1,0,0,3,0.0,3,3,0,3,2,3,4,0
1664,Karol Mets,EST,DF,St. Pauli,de  Bundesliga,31-299,1993.0,10.0,13,8,6,7,0,4,7,57.1,3,9,3,6,12,25,60,0
1665,Thomas Meunier,BEL,DF,Lille,fr  Ligue 1,33-180,1991.0,14.3,42,32,25,13,4,29,39,74.4,10,14,5,9,26,68,48,0
1666,Alexander Meyer,GER,GK,Dortmund,de  Bundesliga,33-332,1991.0,2.0,0,0,0,0,0,0,0,,0,0,0,0,0,0,0,0
1667,Shumaira Mheuka,ENG,MF,Chelsea,eng  Premier League,17-142,2007.0,0.0,0,0,0,0,0,0,0,,0,0,0,0,0,0,0,0
1668,Lucas Michal,FRA,"FW,MF",Monaco,fr  Ligue 1,19-263,2005.0,1.1,5,3,3,2,0,2,4,50.0,2,2,0,2,1,6,2,0
1669,Florian Micheler,AUT,MF,Hoffenheim,de  Bundesliga,19-298,2005.0,0.4,0,0,0,0,0,0,2,0.0,2,0,0,0,0,0,0,0
1670,Miguel,ESP,FW,Leganés,es  La Liga,25-189,1999.0,17.7,16,7,6,4,6,4,14,28.6,10,13,3,10,4,20,22,1
1671,Valentin Mihaila,ROU,"FW,MF",Parma,it  Serie A,25-037,2000.0,14.3,29,15,8,13,8,9,22,40.9,13,18,0,18,8,37,6,0
1672,Georges Mikautadze,GEO,FW,Lyon,fr  Ligue 1,24-131,2000.0,11.2,6,5,1,2,3,3,9,33.3,6,6,0,6,3,9,4,0
1673,Igor Miladinović,SRB,"FW,MF",Saint-Étienne,fr  Ligue 1,21-276,2003.0,0.3,0,0,0,0,0,0,0,,0,0,0,0,1,1,1,0
1674,Nikola Milenković,SRB,DF,Nott'ham Forest,eng  Premier League,27-150,1997.0,27.0,32,20,22,9,1,14,19,73.7,5,34,20,14,19,51,132,0
1675,Lewis Miley,ENG,MF,Newcastle Utd,eng  Premier League,18-314,2006.0,2.1,6,5,3,3,0,4,7,57.1,3,4,1,3,2,8,4,1
1676,Vanja Milinković-Savić,SRB,GK,Torino,it  Serie A,28-019,1997.0,27.0,0,0,0,0,0,0,2,0.0,2,0,0,0,0,0,15,1
1677,Éder Militão,BRA,DF,Real Madrid,es  La Liga,27-052,1998.0,10.4,19,17,14,5,0,7,12,58.3,5,13,8,5,12,31,35,0
1678,Luis Milla,ESP,MF,Getafe,es  La Liga,30-155,1994.0,22.0,43,27,21,18,4,23,46,50.0,23,22,0,22,17,60,19,0
1679,Pere Milla,ESP,"MF,FW",Espanyol,es  La Liga,32-169,1992.0,2.7,3,1,2,0,1,0,11,0.0,11,9,2,7,2,5,3,0
1680,Enzo Millot,FRA,"MF,FW",Stuttgart,de  Bundesliga,22-237,2002.0,16.7,23,11,9,11,3,8,27,29.6,19,21,0,21,10,33,5,1
1681,James Milner,ENG,MF,Brighton,eng  Premier League,39-066,1986.0,1.9,5,2,1,3,1,3,3,100.0,0,4,2,2,2,7,2,1
1682,Kim Min-jae,KOR,DF,Bayern Munich,de  Bundesliga,28-116,1996.0,22.3,32,19,16,12,4,10,18,55.6,8,21,10,11,31,63,75,3
1683,Yerry Mina,COL,DF,Cagliari,it  Serie A,30-169,1994.0,22.1,48,22,34,13,1,31,40,77.5,9,42,25,17,28,76,128,3
1684,Takumi Minamino,JPN,"MF,FW",Monaco,fr  Ligue 1,30-054,1995.0,17.5,23,11,5,11,7,10,28,35.7,18,16,1,15,9,32,16,0
1685,Lucas Mincarelli,FRA,DF,Montpellier,fr  Ligue 1,21-065,2004.0,2.8,4,4,1,2,1,1,5,20.0,4,1,1,0,1,5,8,0
1686,Tyrone Mings,ENG,DF,Aston Villa,eng  Premier League,31-363,1993.0,8.7,6,5,5,1,0,2,2,100.0,0,12,10,2,5,11,44,1
1687,Óscar Mingueza,ESP,"MF,DF",Celta Vigo,es  La Liga,25-302,1999.0,21.1,27,16,15,9,3,20,52,38.5,32,18,4,14,16,43,29,3
1688,Kim Minsu,KOR,"MF,FW",Girona,es  La Liga,19-051,2006.0,0.2,1,0,0,1,0,0,0,,0,0,0,0,0,1,0,0
1689,Yankuba Minteh,GAM,"FW,MF",Brighton,eng  Premier League,20-232,2004.0,13.1,32,24,18,7,7,12,33,36.4,21,16,0,16,10,42,21,0
1690,Bojan Miovski,MKD,FW,Girona,es  La Liga,25-260,1999.0,8.8,7,5,2,2,3,2,7,28.6,5,4,0,4,2,9,7,0
1691,Rafa Mir,ESP,"MF,FW",Valencia,es  La Liga,27-266,1997.0,4.1,8,5,5,3,0,2,5,40.0,3,1,0,1,1,9,5,0
1692,Juan Miranda,ESP,DF,Bologna,it  Serie A,25-051,2000.0,17.6,25,15,9,10,6,11,24,45.8,13,16,2,14,18,43,33,1
1693,Fabio Miretti,ITA,"MF,FW",Genoa,it  Serie A,21-220,2003.0,16.0,28,15,6,14,8,18,30,60.0,12,19,1,18,6,34,12,1
1694,Tyrick Mitchell,ENG,DF,Crystal Palace,eng  Premier League,25-191,1999.0,26.7,74,48,48,21,5,20,37,54.1,17,53,9,44,11,85,79,2
1695,Kaoru Mitoma,JPN,"FW,MF",Brighton,eng  Premier League,27-295,1997.0,24.8,35,19,12,13,10,15,40,37.5,25,41,3,38,12,47,9,0
1696,Maximilian Mittelstädt,GER,DF,Stuttgart,de  Bundesliga,27-358,1997.0,19.9,59,43,37,20,2,38,54,70.4,16,37,10,27,26,85,70,1
1697,Koji Miyoshi,JPN,"FW,MF",Bochum,de  Bundesliga,27-350,1997.0,5.0,8,5,2,1,5,4,9,44.4,5,10,1,9,2,10,2,0
1698,Henrikh Mkhitaryan,ARM,MF,Inter,it  Serie A,36-049,1989.0,21.8,31,19,12,12,7,15,35,42.9,20,23,4,19,16,47,33,0
1699,Jakub Moder,POL,MF,Brighton,eng  Premier League,25-338,1999.0,0.1,1,0,1,0,0,0,2,0.0,2,0,0,0,0,1,3,0
1700,Rui Modesto,ANG,DF,Udinese,it  Serie A,25-155,1999.0,2.9,8,5,1,5,2,4,5,80.0,1,2,0,2,5,13,8,0
1701,Luka Modrić,CRO,MF,Real Madrid,es  La Liga,39-183,1985.0,13.8,21,11,13,7,1,11,26,42.3,15,11,4,7,19,40,13,0
1702,Max Moerstedt,GER,FW,Hoffenheim,de  Bundesliga,,,5.0,5,5,1,3,1,1,2,50.0,1,4,0,4,0,5,5,0
1703,Mostafa Mohamed,EGY,FW,Nantes,fr  Ligue 1,27-103,1997.0,9.8,15,8,5,6,4,4,12,33.3,8,7,1,6,8,23,22,0
1704,Johan Mojica,COL,DF,Mallorca,es  La Liga,32-202,1992.0,22.5,28,17,21,4,3,16,28,57.1,12,7,2,5,24,52,63,2
1705,David Mokwa,FRA,"DF,FW",Hoffenheim,de  Bundesliga,20-312,2004.0,0.2,1,0,1,0,0,0,0,,0,0,0,0,0,1,0,0
1706,Alberto Moleiro,ESP,"FW,MF",Las Palmas,es  La Liga,21-162,2003.0,21.1,22,10,9,12,1,17,40,42.5,23,20,0,20,12,34,7,0
1707,Nahuel Molina,ARG,DF,Atlético Madrid,es  La Liga,26-339,1998.0,14.3,35,16,15,19,1,25,45,55.6,20,16,3,13,10,45,40,0
1708,Florent Mollet,FRA,"MF,FW",Nantes,fr  Ligue 1,33-112,1991.0,2.7,2,2,1,1,0,1,1,100.0,0,2,0,2,1,3,4,0
1709,Jon Moncayola,ESP,MF,Osasuna,es  La Liga,26-302,1998.0,18.3,50,28,16,27,7,22,46,47.8,24,30,2,28,11,61,17,0
1710,Gonzalo Montiel,ARG,"DF,MF",Sevilla,es  La Liga,28-069,1997.0,1.3,4,2,3,1,0,3,4,75.0,1,0,0,0,2,6,11,0
1711,Lorenzo Montipò,ITA,GK,Hellas Verona,it  Serie A,29-019,1996.0,27.0,1,0,1,0,0,1,4,25.0,3,0,0,0,0,1,15,4
1712,Mikey Moore,ENG,"FW,MF",Tottenham,eng  Premier League,17-212,2007.0,2.1,0,0,0,0,0,0,1,0.0,1,1,0,1,1,1,1,0
1713,Álvaro Morata,ESP,"FW,MF",Milan,it  Serie A,32-139,1992.0,12.2,16,10,5,8,3,5,8,62.5,3,7,2,5,5,21,5,0
1714,Morato,BRA,DF,Nott'ham Forest,eng  Premier League,23-254,2001.0,6.7,18,12,15,2,1,11,18,61.1,7,9,4,5,8,26,62,2
1715,Diego Moreira,POR,"DF,MF",Strasbourg,fr  Ligue 1,20-217,2004.0,21.4,30,18,11,14,5,15,33,45.5,18,18,2,16,25,55,53,0
1716,Alberto Moreno,ESP,DF,Como,it  Serie A,32-249,1992.0,15.1,23,10,15,8,0,11,19,57.9,8,10,2,8,12,35,27,2
1717,Álex Moreno,ESP,DF,Nott'ham Forest,eng  Premier League,31-276,1993.0,9.0,24,18,19,5,0,14,34,41.2,20,11,5,6,14,38,33,0
1718,Gerard Moreno,ESP,FW,Villarreal,es  La Liga,32-338,1992.0,6.7,7,4,3,2,2,3,8,37.5,5,0,0,0,2,9,5,0
1719,Matias Moreno,ARG,DF,Fiorentina,it  Serie A,21-168,2003.0,1.6,8,8,5,3,0,4,4,100.0,0,5,1,4,1,9,9,0
1720,Tete Morente,ESP,FW,Lecce,it  Serie A,28-097,1996.0,17.1,21,12,8,9,4,7,29,24.1,22,15,1,14,12,33,23,1
1721,Mateu Morey,ESP,DF,Mallorca,es  La Liga,25-009,2000.0,4.2,9,8,5,3,1,6,13,46.2,7,6,0,6,9,18,11,1
1722,Ilaix Moriba,GUI,MF,Celta Vigo,es  La Liga,22-051,2003.0,15.3,41,26,14,19,8,21,39,53.8,18,21,4,17,8,49,24,0
1723,Manu Morlanes,ESP,MF,Mallorca,es  La Liga,26-058,1999.0,11.9,33,21,14,14,5,15,23,65.2,8,18,7,11,23,56,15,0
1724,Nikola Moro,CRO,MF,Bologna,it  Serie A,26-364,1998.0,12.3,34,26,6,21,7,21,32,65.6,11,18,7,11,13,47,16,0
1725,Raúl Moro,ESP,"FW,MF",Valladolid,es  La Liga,22-096,2002.0,17.0,15,9,11,2,2,8,23,34.8,15,6,0,6,9,24,12,0
1726,Sam Morsy,EGY,MF,Ipswich Town,eng  Premier League,33-182,1991.0,22.0,53,29,28,21,4,22,52,42.3,30,22,8,14,22,75,36,4
1727,Gabriel Moscardo,BRA,MF,Reims,fr  Ligue 1,19-164,2005.0,0.4,2,0,2,0,0,1,3,33.3,2,1,1,0,0,2,0,0
1728,Cristhian Mosquera,ESP,DF,Valencia,es  La Liga,20-257,2004.0,25.9,36,26,27,8,1,18,24,75.0,6,26,17,9,30,66,79,3
1729,Daniel Mosquera,COL,FW,Hellas Verona,it  Serie A,25-142,1999.0,9.5,7,5,3,1,3,0,6,0.0,6,7,1,6,1,8,7,0
1730,Yerson Mosquera,COL,DF,Wolves,eng  Premier League,23-313,2001.0,4.9,11,7,9,2,0,9,14,64.3,5,13,10,3,10,21,14,0
1731,Dany Mota,POR,"MF,FW",Monza,it  Serie A,26-313,1998.0,16.2,11,2,2,1,8,3,6,50.0,3,15,1,14,8,19,20,1
1732,Yael Mouanga,FRA,DF,Montpellier,fr  Ligue 1,19-231,2005.0,5.5,6,3,4,1,1,3,5,60.0,2,8,6,2,4,10,30,0
1733,Aimen Moueffek,FRA,MF,Saint-Étienne,fr  Ligue 1,23-336,2001.0,6.9,16,9,3,10,3,7,17,41.2,10,10,3,7,3,19,19,1
1734,Youssoufa Moukoko,GER,"FW,MF",Nice,fr  Ligue 1,20-111,2004.0,2.3,3,2,2,1,0,1,2,50.0,1,2,0,2,0,3,0,0
1735,Steve Mounié,BEN,"FW,MF",Augsburg,de  Bundesliga,30-163,1994.0,3.3,3,3,0,1,2,0,1,0.0,1,1,1,0,0,3,4,0
1736,Mason Mount,ENG,"MF,FW",Manchester Utd,eng  Premier League,26-060,1999.0,2.7,6,2,3,3,0,5,7,71.4,2,4,1,3,0,6,0,0
1737,Santiago Mouriño,URU,DF,Alavés,es  La Liga,23-026,2002.0,11.5,23,15,16,7,0,10,18,55.6,8,16,5,11,19,42,60,0
1738,Louis Mouton,FRA,MF,Saint-Étienne,fr  Ligue 1,22-281,2002.0,10.5,39,19,12,18,9,16,28,57.1,12,15,2,13,10,49,16,0
1739,Divin Mubama,ENG,FW,Manchester City,eng  Premier League,20-137,2004.0,0.3,0,0,0,0,0,0,0,,0,0,0,0,0,0,0,0
1740,Mykhailo Mudryk,UKR,FW,Chelsea,eng  Premier League,24-065,2001.0,1.7,2,2,2,0,0,0,0,,0,3,1,2,0,2,1,0
1741,Ngal'Ayel Mukau,COD,MF,Lille,fr  Ligue 1,20-101,2004.0,10.6,26,15,9,15,2,14,24,58.3,10,11,0,11,13,39,17,0
1742,Nordi Mukiele,FRA,DF,Leverkusen,de  Bundesliga,27-130,1997.0,8.0,17,14,6,8,3,9,14,64.3,5,6,0,6,9,26,28,2
1743,Florian Müller,GER,GK,Freiburg,de  Bundesliga,27-118,1997.0,3.0,0,0,0,0,0,0,0,,0,0,0,0,0,0,0,0
1744,Kevin Müller,GER,GK,Heidenheim,de  Bundesliga,33-361,1991.0,25.0,3,2,3,0,0,3,3,100.0,0,0,0,0,0,3,9,3
1745,Marius Müller,GER,GK,Wolfsburg,de  Bundesliga,31-242,1993.0,5.3,0,0,0,0,0,0,0,,0,0,0,0,0,0,0,0
1746,Thomas Müller,GER,"MF,FW",Bayern Munich,de  Bundesliga,35-179,1989.0,9.6,4,2,1,2,1,2,11,18.2,9,7,0,7,0,4,8,0
1747,Abdul Mumin,GHA,DF,Rayo Vallecano,es  La Liga,26-278,1998.0,22.4,37,25,30,7,0,17,27,63.0,10,40,29,11,23,60,125,0
1748,Marshall Munetsi,ZIM,"FW,MF",Wolves,eng  Premier League,28-262,1996.0,3.0,7,4,2,3,2,4,8,50.0,4,3,1,2,2,9,5,0
1749,Marshall Munetsi,ZIM,MF,Reims,fr  Ligue 1,28-262,1996.0,18.8,36,18,22,9,5,22,38,57.9,16,27,3,24,17,53,35,0
1750,Rodrigo Muniz,BRA,FW,Fulham,eng  Premier League,23-311,2001.0,8.8,8,4,3,3,2,4,4,100.0,0,9,2,7,4,12,12,0
1751,Aihen Muñoz,ESP,DF,Real Sociedad,es  La Liga,27-207,1997.0,6.6,13,8,9,4,0,10,20,50.0,10,7,5,2,11,24,32,0
1752,Álex Muñoz,ESP,DF,Las Palmas,es  La Liga,30-224,1994.0,13.9,37,29,22,14,1,20,37,54.1,17,26,11,15,16,53,63,0
1753,Daniel Muñoz,COL,DF,Crystal Palace,eng  Premier League,28-289,1996.0,26.0,93,61,46,29,18,40,70,57.1,30,27,2,25,31,124,75,1
1754,Iker Muñoz,ESP,MF,Osasuna,es  La Liga,22-126,2002.0,4.2,5,2,3,2,0,3,4,75.0,1,6,1,5,3,8,7,1
1755,Javier Muñoz,ESP,"MF,DF",Las Palmas,es  La Liga,30-011,1995.0,22.0,38,29,17,13,8,14,36,38.9,22,18,3,15,23,61,32,3
1756,Arijanet Muric,KVX,GK,Ipswich Town,eng  Premier League,26-124,1998.0,18.0,0,0,0,0,0,0,2,0.0,2,0,0,0,0,0,10,5
1757,Murillo,BRA,DF,Nott'ham Forest,eng  Premier League,22-250,2002.0,26.5,42,30,28,11,3,22,37,59.5,15,58,37,21,26,68,176,2
1758,Vedat Muriqi,KVX,FW,Mallorca,es  La Liga,30-321,1994.0,18.0,5,4,3,1,1,2,5,40.0,3,4,1,3,7,12,31,0
1759,Jacob Murphy,ENG,FW,Newcastle Utd,eng  Premier League,30-015,1995.0,18.7,18,12,7,6,5,13,23,56.5,10,26,0,26,11,29,19,1
1760,Bob Murphy Omoregbe,ITA,MF,Milan,it  Serie A,21-126,2003.0,0.0,0,0,0,0,0,0,0,,0,0,0,0,0,0,0,0
1761,Yunus Musah,USA,"MF,FW",Milan,it  Serie A,22-102,2002.0,14.9,23,16,10,9,4,9,13,69.2,4,8,1,7,7,30,8,2
1762,Jamal Musiala,GER,MF,Bayern Munich,de  Bundesliga,22-013,2003.0,17.5,31,16,7,14,10,10,25,40.0,15,25,0,25,6,37,5,1
1763,Florent Muslija,KVX,"FW,MF",Freiburg,de  Bundesliga,26-248,1998.0,1.9,5,4,3,1,1,2,2,100.0,0,0,0,0,1,6,1,0
1764,Almoatasem Al Musrati,LBY,MF,Monaco,fr  Ligue 1,28-339,1996.0,2.7,7,6,2,4,1,2,4,50.0,2,2,1,1,4,11,4,0
1765,Juan Musso,ARG,GK,Atalanta,it  Serie A,30-309,1994.0,1.0,0,0,0,0,0,0,0,,0,0,0,0,0,0,0,0
1766,Juan Musso,ARG,GK,Atlético Madrid,es  La Liga,30-309,1994.0,1.0,0,0,0,0,0,0,0,,0,0,0,0,0,0,0,0
1767,Kingstone Mutandwa,ZAM,"MF,FW",Cagliari,it  Serie A,22-065,2003.0,0.6,0,0,0,0,0,0,0,,0,0,0,0,0,0,0,0
1768,Junior Mwanga,FRA,MF,Le Havre,fr  Ligue 1,21-304,2003.0,2.6,7,4,2,4,1,3,4,75.0,1,4,0,4,3,10,6,1
1769,Junior Mwanga,FRA,MF,Strasbourg,fr  Ligue 1,21-304,2003.0,3.3,17,9,9,7,1,5,9,55.6,4,2,0,2,2,19,2,0
1770,Phillipp Mwene,AUT,DF,Mainz 05,de  Bundesliga,31-041,1994.0,24.0,40,23,15,20,5,13,36,36.1,23,25,6,19,22,62,46,0
1771,Vitaliy Mykolenko,UKR,DF,Everton,eng  Premier League,25-286,1999.0,25.2,48,27,28,12,8,22,41,53.7,19,18,8,10,29,77,110,1
1772,Joakim Mæhle,DEN,DF,Wolfsburg,de  Bundesliga,27-295,1997.0,16.3,24,9,18,6,0,11,29,37.9,18,18,3,15,18,42,37,1
1773,Obite N'Dicka,CIV,DF,Roma,it  Serie A,25-203,1999.0,28.0,23,17,11,12,0,9,14,64.3,5,36,25,11,30,53,110,1
1774,Konan N'dri,CIV,"FW,MF",Lecce,it  Serie A,24-135,2000.0,0.1,0,0,0,0,0,0,0,,0,0,0,0,0,0,0,0
1775,Loïc N'Gatta,FRA,DF,Auxerre,fr  Ligue 1,21-090,2003.0,0.1,1,1,0,1,0,1,2,50.0,1,1,0,1,0,1,1,0
1776,Nathan N'Goumou,FRA,FW,Gladbach,de  Bundesliga,24-362,2000.0,8.3,15,9,9,4,2,6,10,60.0,4,8,2,6,4,19,15,0
1777,Djylian N'Guessan,FRA,FW,Saint-Étienne,fr  Ligue 1,16-193,2008.0,1.4,3,2,2,1,0,1,3,33.3,2,1,0,1,0,3,1,0
1778,Stanley N'Soki,FRA,DF,Hoffenheim,de  Bundesliga,25-336,1999.0,10.3,17,12,10,6,1,9,17,52.9,8,13,3,10,20,37,41,2
1779,Mickael Nade,FRA,DF,Saint-Étienne,fr  Ligue 1,26-007,1999.0,16.6,41,28,26,15,0,17,23,73.9,6,22,10,12,27,68,83,5
1780,Bilal Nadir,FRA,MF,Marseille,fr  Ligue 1,21-103,2003.0,3.3,8,1,4,4,0,4,6,66.7,2,6,1,5,1,9,3,0
1781,Mahamadou Nagida,CMR,DF,Rennes,fr  Ligue 1,19-256,2005.0,4.8,8,6,4,3,1,4,5,80.0,1,3,0,3,9,17,6,0
1782,Keito Nakamura,JPN,FW,Reims,fr  Ligue 1,24-226,2000.0,21.6,19,12,7,6,6,10,22,45.5,12,16,0,16,8,27,9,0
1783,Sebastian Nanasi,SWE,"FW,MF",Strasbourg,fr  Ligue 1,22-299,2002.0,18.7,17,10,5,10,2,6,17,35.3,11,20,3,17,6,23,14,0
1784,Yael Nandjou,FRA,DF,Nice,fr  Ligue 1,19-248,2005.0,1.7,4,1,2,1,1,4,8,50.0,4,4,1,3,4,8,7,0
1785,Matija Nastasić,SRB,DF,Leganés,es  La Liga,31-348,1993.0,19.9,22,10,19,3,0,14,21,66.7,7,34,25,9,18,40,139,0
1786,Natan,BRA,DF,Betis,es  La Liga,24-033,2001.0,14.7,25,16,17,6,2,17,19,89.5,2,17,9,8,17,42,71,0
1787,Pau Navarro,ESP,DF,Villarreal,es  La Liga,19-320,2005.0,5.8,15,10,9,4,2,12,20,60.0,8,10,5,5,3,18,21,0
1788,Roberto Navarro,ESP,"MF,FW",Mallorca,es  La Liga,22-333,2002.0,14.2,29,22,14,11,4,9,19,47.4,10,18,0,18,19,48,12,0
1789,Jesús Navas,ESP,"FW,MF",Sevilla,es  La Liga,39-110,1985.0,4.7,5,2,3,0,2,0,3,0.0,3,1,0,1,4,9,6,0
1790,Michel Ndary Adopo,FRA,MF,Cagliari,it  Serie A,24-235,2000.0,17.5,36,23,11,22,3,9,17,52.9,8,11,1,10,14,50,14,0
1791,Youssouf Ndayishimiye,BDI,DF,Nice,fr  Ligue 1,26-135,1998.0,15.5,34,16,22,11,1,13,21,61.9,8,28,14,14,16,50,85,2
1792,Iliman Ndiaye,SEN,FW,Everton,eng  Premier League,25-005,2000.0,20.9,44,22,18,13,13,18,43,41.9,25,21,4,17,17,61,19,1
1793,Junior Ndiaye,FRA,FW,Montpellier,fr  Ligue 1,19-347,2005.0,1.2,1,0,1,0,0,0,0,,0,1,1,0,0,1,1,0
1794,Rassoul Ndiaye,SEN,MF,Le Havre,fr  Ligue 1,23-090,2001.0,11.0,28,19,17,9,2,8,20,40.0,12,14,4,10,10,38,23,0
1795,Wilfred Ndidi,NGA,MF,Leicester City,eng  Premier League,28-085,1996.0,17.3,59,34,33,23,3,20,42,47.6,22,34,13,21,15,74,61,0
1796,Wilfried Ndollo,CMR,DF,Montpellier,fr  Ligue 1,19-241,2005.0,0.1,1,1,1,0,0,1,1,100.0,0,0,0,0,1,2,0,0
1797,Tanguy Ndombele,FRA,MF,Nice,fr  Ligue 1,28-073,1996.0,12.6,35,23,10,21,4,12,20,60.0,8,9,0,9,14,49,9,0
1798,Cher Ndour,ITA,"MF,FW",Fiorentina,it  Serie A,20-227,2004.0,2.4,2,0,1,1,0,0,5,0.0,5,4,1,3,2,4,4,0
1799,Dan Ndoye,SUI,FW,Bologna,it  Serie A,24-137,2000.0,17.9,14,12,3,5,6,9,18,50.0,9,18,0,18,5,19,4,0
1800,Paul Nebel,GER,MF,Mainz 05,de  Bundesliga,22-152,2002.0,18.1,26,16,7,11,8,9,26,34.6,17,33,3,30,9,35,26,2
1801,Kosta Nedeljković,SRB,DF,Aston Villa,eng  Premier League,19-085,2005.0,1.4,7,5,1,3,3,2,3,66.7,1,1,0,1,0,7,3,0
1802,Kosta Nedeljković,SRB,"DF,FW",RB Leipzig,de  Bundesliga,19-085,2005.0,0.4,1,1,1,0,0,1,1,100.0,0,2,1,1,0,1,0,0
1803,Loïc Nego,HUN,"DF,FW",Le Havre,fr  Ligue 1,34-055,1991.0,18.3,35,20,22,10,3,25,40,62.5,15,14,2,12,20,55,55,0
1804,Ivan Nekić,CRO,DF,Holstein Kiel,de  Bundesliga,24-077,2000.0,0.8,1,1,1,0,0,1,2,50.0,1,1,0,1,3,4,2,0
1805,Reiss Nelson,ENG,FW,Arsenal,eng  Premier League,25-091,1999.0,0.0,1,0,0,1,0,0,1,0.0,1,0,0,0,0,1,1,0
1806,Reiss Nelson,ENG,FW,Fulham,eng  Premier League,25-091,1999.0,5.4,8,6,3,3,2,5,13,38.5,8,11,0,11,5,13,2,0
1807,Victor Nelsson,DEN,DF,Roma,it  Serie A,26-148,1998.0,1.9,5,4,3,1,1,3,4,75.0,1,1,0,1,2,7,8,0
1808,David Nemeth,AUT,DF,St. Pauli,de  Bundesliga,23-358,2001.0,14.7,30,23,18,11,1,16,32,50.0,16,19,7,12,9,39,60,2
1809,David Neres,BRA,FW,Napoli,it  Serie A,28-008,1997.0,10.9,12,6,4,3,5,6,10,60.0,4,5,0,5,6,18,4,0
1810,Neto,BRA,GK,Bournemouth,eng  Premier League,35-235,1989.0,2.0,0,0,0,0,0,0,0,,0,0,0,0,0,0,1,1
1811,Pedro Neto,POR,FW,Chelsea,eng  Premier League,25-002,2000.0,16.0,15,8,5,8,2,6,15,40.0,9,9,1,8,7,22,3,0
1812,Luca Netz,GER,DF,Gladbach,de  Bundesliga,21-300,2003.0,8.8,22,12,13,7,2,11,17,64.7,6,15,3,12,10,32,21,0
1813,Manuel Neuer,GER,GK,Bayern Munich,de  Bundesliga,38-349,1986.0,20.0,1,0,1,0,0,1,1,100.0,0,0,0,0,0,1,8,1
1814,Florian Neuhaus,GER,MF,Gladbach,de  Bundesliga,27-360,1997.0,2.6,4,0,2,2,0,3,10,30.0,7,5,0,5,4,8,3,1
1815,João Neves,POR,"MF,DF",Paris S-G,fr  Ligue 1,20-165,2004.0,15.8,54,28,16,24,14,23,39,59.0,16,23,7,16,19,73,17,1
1816,Yvan Neyou,CMR,MF,Leganés,es  La Liga,28-067,1997.0,20.3,50,33,20,24,6,22,39,56.4,17,27,3,24,19,69,33,1
1817,Cyril Ngonge,BEL,"FW,DF",Napoli,it  Serie A,24-289,2000.0,1.9,7,5,4,3,0,3,5,60.0,2,2,0,2,1,8,4,0
1818,Mikayil Ngor Faye,SEN,DF,Rennes,fr  Ligue 1,20-240,2004.0,6.6,12,9,9,2,1,6,6,100.0,0,5,3,2,9,21,25,0
1819,Steve Ngoura,FRA,FW,Le Havre,fr  Ligue 1,20-017,2005.0,3.2,4,2,1,1,2,3,3,100.0,0,2,1,1,0,4,2,0
1820,Bernard Nguene,CMR,FW,Nice,fr  Ligue 1,18-219,2006.0,0.1,0,0,0,0,0,0,0,,0,0,0,0,0,0,0,0
1821,Moussa Niakhate,SEN,DF,Lyon,fr  Ligue 1,29-003,1996.0,21.3,37,20,31,5,1,18,25,72.0,7,17,10,7,15,52,111,3
1822,Abdoulaye Niakhate Ndiaye,SEN,DF,Brest,fr  Ligue 1,22-335,2002.0,11.5,24,17,16,8,0,13,21,61.9,8,15,7,8,7,31,90,1
1823,Ibrahima Niane,SEN,FW,Angers,fr  Ligue 1,26-000,1999.0,9.8,6,3,3,2,1,3,3,100.0,0,5,1,4,2,8,4,2
1824,Tanguy Nianzou,FRA,DF,Sevilla,es  La Liga,22-277,2002.0,5.8,7,5,6,0,1,5,6,83.3,1,1,0,1,8,15,27,0
1825,Cheikh Niasse,SEN,MF,Hellas Verona,it  Serie A,25-051,2000.0,5.4,12,10,4,8,0,7,11,63.6,4,12,4,8,14,26,14,2
1826,Rasmus Nicolaisen,DEN,DF,Toulouse,fr  Ligue 1,27-360,1997.0,6.9,6,3,4,2,0,3,5,60.0,2,10,5,5,10,16,25,0
1827,Moritz Nicolas,GER,GK,Gladbach,de  Bundesliga,27-141,1997.0,18.2,0,0,0,0,0,0,0,,0,1,0,1,1,1,8,1
1828,Hans Nicolussi Caviglia,ITA,MF,Venezia,it  Serie A,24-266,2000.0,22.8,36,19,10,19,7,23,54,42.6,31,27,7,20,20,56,39,2
1829,Julian Niehues,GER,MF,Heidenheim,de  Bundesliga,23-328,2001.0,0.6,1,0,1,0,0,1,2,50.0,1,1,0,1,0,1,1,0
1830,Saúl Ñíguez,ESP,MF,Sevilla,es  La Liga,30-110,1994.0,12.8,34,22,12,17,5,9,24,37.5,15,22,2,20,17,51,24,0
1831,Eybi Nije,SWE,"FW,MF",Torino,it  Serie A,19-301,2005.0,4.4,5,1,3,1,1,0,3,0.0,3,5,1,4,0,5,1,0
1832,Tamás Nikitscher,HUN,MF,Valladolid,es  La Liga,25-128,1999.0,4.1,12,5,7,5,0,6,7,85.7,1,5,1,4,8,20,6,0
1833,Adrian Niño,ESP,FW,Atlético Madrid,es  La Liga,20-265,2004.0,0.1,0,0,0,0,0,0,0,,0,0,0,0,0,0,0,0
1834,Justin Njinmah,GER,"FW,MF",Werder Bremen,de  Bundesliga,24-116,2000.0,8.5,3,2,1,2,0,2,3,66.7,1,5,0,5,3,6,1,0
1835,Eddie Nketiah,ENG,"MF,FW",Crystal Palace,eng  Premier League,25-285,1999.0,7.9,12,5,6,2,4,5,11,45.5,6,8,0,8,2,14,8,0
1836,Niels Nkounkou,FRA,"DF,MF",Eint Frankfurt,de  Bundesliga,24-130,2000.0,4.2,13,10,7,3,3,4,7,57.1,3,5,2,3,7,20,14,0
1837,Christopher Nkunku,FRA,FW,Chelsea,eng  Premier League,27-117,1997.0,8.9,8,6,0,4,4,3,4,75.0,1,8,2,6,7,15,8,0
1838,Felix Nmecha,GER,MF,Dortmund,de  Bundesliga,24-152,2000.0,12.6,27,18,3,16,8,9,16,56.3,7,18,5,13,18,45,25,0
1839,Lukas Nmecha,GER,FW,Wolfsburg,de  Bundesliga,26-087,1998.0,2.5,1,0,0,1,0,0,1,0.0,1,1,0,1,2,3,3,0
1840,Arnaud Nordin,FRA,FW,Montpellier,fr  Ligue 1,26-267,1998.0,13.0,24,15,6,16,2,11,21,52.4,10,12,0,12,5,29,7,0
1841,Arnaud Nordin,FRA,DF,Mainz 05,de  Bundesliga,26-267,1998.0,0.2,0,0,0,0,0,0,0,,0,0,0,0,0,0,0,0
1842,Brooke Norton-Cuffy,ENG,"DF,MF",Genoa,it  Serie A,21-058,2004.0,2.2,5,3,3,2,0,3,4,75.0,1,3,0,3,2,7,1,0
1843,Tijjani Noslin,NED,"FW,MF",Lazio,it  Serie A,25-247,1999.0,8.2,5,4,1,1,3,1,5,20.0,4,15,1,14,1,6,7,0
1844,Hugo Novoa,ESP,"DF,MF",Alavés,es  La Liga,22-069,2003.0,2.6,8,5,4,3,1,5,5,100.0,0,2,1,1,0,8,6,0
1845,Plamedi Nsingi,nan,MF,Nantes,fr  Ligue 1,24-084,2000.0,0.2,1,0,1,0,0,0,1,0.0,1,0,0,0,0,1,0,0
1846,Randy Nteka,ANG,FW,Rayo Vallecano,es  La Liga,27-095,1997.0,9.7,11,5,2,7,2,4,11,36.4,7,10,2,8,4,15,12,0
1847,Ernest Nuamah,GHA,"FW,MF",Lyon,fr  Ligue 1,21-130,2003.0,10.0,17,7,11,4,2,10,22,45.5,12,8,1,7,5,22,8,1
1848,Alexander Nübel,GER,GK,Stuttgart,de  Bundesliga,28-162,1996.0,25.0,0,0,0,0,0,0,1,0.0,1,0,0,0,0,0,12,2
1849,Matheus Nunes,POR,"DF,MF",Manchester City,eng  Premier League,26-196,1998.0,11.6,26,17,11,9,6,12,26,46.2,14,12,3,9,11,37,23,0
1850,Darwin Núñez,URU,FW,Liverpool,eng  Premier League,25-260,1999.0,10.8,18,15,10,3,5,5,15,33.3,10,6,0,6,3,21,12,0
1851,Unai Núñez,ESP,DF,Athletic Club,es  La Liga,28-040,1997.0,3.4,2,2,1,1,0,0,1,0.0,1,2,2,0,14,16,17,1
1852,Antonio Nusa,NOR,"MF,DF",RB Leipzig,de  Bundesliga,19-328,2005.0,16.0,30,17,16,9,5,18,36,50.0,18,20,2,18,8,38,11,0
1853,Ethan Nwaneri,ENG,"FW,MF",Arsenal,eng  Premier League,17-355,2007.0,6.6,9,6,4,2,3,5,14,35.7,9,7,1,6,1,10,2,1
1854,Ørjan Nyland,NOR,GK,Sevilla,es  La Liga,34-182,1990.0,19.7,2,1,2,0,0,2,3,66.7,1,0,0,0,0,2,10,3
1855,Allan Nyom,CMR,"DF,MF",Getafe,es  La Liga,36-305,1988.0,7.1,12,7,5,6,1,9,11,81.8,2,2,1,1,2,14,14,0
1856,Rabby Nzingoula,CGO,MF,Montpellier,fr  Ligue 1,19-106,2005.0,14.0,44,27,17,21,6,19,44,43.2,25,19,4,15,25,69,19,0
1857,M'Bala Nzola,ANG,FW,Lens,fr  Ligue 1,28-205,1996.0,14.6,5,4,0,1,4,3,8,37.5,5,7,1,6,4,9,6,0
1858,Marwann Nzuzi,FRA,DF,Saint-Étienne,fr  Ligue 1,20-299,2004.0,1.4,2,2,1,0,1,1,2,50.0,1,0,0,0,2,4,6,0
1859,Christian Nørgaard,DEN,MF,Brentford,eng  Premier League,31-001,1994.0,21.3,62,38,26,30,6,36,57,63.2,21,33,12,21,36,98,48,1
1860,Jake O'Brien,IRL,DF,Everton,eng  Premier League,23-300,2001.0,8.5,15,9,14,1,0,9,12,75.0,3,7,2,5,3,18,56,0
1861,Matt O'Riley,DEN,MF,Brighton,eng  Premier League,24-110,2000.0,5.3,9,7,1,6,2,2,8,25.0,6,4,1,3,11,20,4,1
1862,Dara O'Shea,IRL,DF,Ipswich Town,eng  Premier League,26-007,1999.0,24.7,37,23,23,11,3,15,24,62.5,9,44,35,9,27,64,145,4
1863,Adam Obert,SVK,DF,Cagliari,it  Serie A,22-200,2002.0,9.7,28,16,11,17,0,14,25,56.0,11,16,7,9,18,46,38,2
1864,Chidozie Obi-Martin,DEN,FW,Manchester Utd,eng  Premier League,17-102,2007.0,0.2,0,0,0,0,0,0,0,,0,0,0,0,0,0,0,0
1865,Jan Oblak,SVN,GK,Atlético Madrid,es  La Liga,32-063,1993.0,26.0,0,0,0,0,0,0,0,,0,0,0,0,0,0,8,2
1866,Lucas Ocampos,ARG,FW,Sevilla,es  La Liga,30-243,1994.0,1.9,3,2,2,0,1,1,2,50.0,1,2,0,2,0,3,2,0
1867,Jens Odgaard,DEN,"MF,FW",Bologna,it  Serie A,25-345,1999.0,16.6,20,14,3,12,5,6,19,31.6,13,11,2,9,8,28,10,1
1868,Wilson Odobert,FRA,FW,Tottenham,eng  Premier League,20-103,2004.0,3.8,5,2,2,2,1,4,6,66.7,2,2,0,2,1,6,1,1
1869,Álvaro Odriozola,ESP,DF,Real Sociedad,es  La Liga,29-087,1995.0,0.5,1,1,1,0,0,0,0,,0,0,0,0,0,1,1,0
1870,Tim Oermann,GER,DF,Bochum,de  Bundesliga,21-156,2003.0,15.9,31,19,17,12,2,16,30,53.3,14,22,10,12,15,46,37,0
1871,Chiedozie Ogbene,IRL,FW,Ipswich Town,eng  Premier League,27-314,1997.0,2.6,7,3,1,2,4,2,4,50.0,2,1,0,1,1,8,3,0
1872,Ifechukwu Ogbus,SUI,DF,Freiburg,de  Bundesliga,19-084,2005.0,0.2,1,1,0,0,1,0,1,0.0,1,0,0,0,1,2,2,0
1873,Thiago Ojeda,ARG,MF,Villarreal,es  La Liga,22-058,2003.0,0.1,0,0,0,0,0,0,0,,0,0,0,0,0,0,1,0
1874,Hamzat Ojediran,NGA,"MF,FW",Lens,fr  Ligue 1,21-117,2003.0,4.2,25,13,11,12,2,5,15,33.3,10,10,2,8,10,35,7,0
1875,Noah Okafor,SUI,"FW,MF",Napoli,it  Serie A,24-291,2000.0,0.3,1,1,1,0,0,0,0,,0,0,0,0,0,1,1,0
1876,Noah Okafor,SUI,FW,Milan,it  Serie A,24-291,2000.0,4.6,2,1,0,0,2,0,1,0.0,1,1,0,1,2,4,1,0
1877,Caleb Okoli,ITA,DF,Leicester City,eng  Premier League,23-241,2001.0,11.1,24,13,8,14,2,10,17,58.8,7,22,12,10,14,38,72,2
1878,Yllan Okou,FRA,DF,Hellas Verona,it  Serie A,22-078,2002.0,0.0,0,0,0,0,0,0,0,,0,1,0,1,0,0,0,0
1879,Maduka Okoye,NGA,GK,Udinese,it  Serie A,25-195,1999.0,15.0,0,0,0,0,0,0,0,,0,0,0,0,0,0,4,1
1880,Joseph Okumu,KEN,DF,Reims,fr  Ligue 1,27-289,1997.0,13.2,25,13,19,6,0,13,20,65.0,7,23,15,8,20,45,75,2
1881,Kazeem Olaigbe,BEL,"FW,MF",Rennes,fr  Ligue 1,22-068,2003.0,0.5,0,0,0,0,0,0,0,,0,0,0,0,0,0,0,0
1882,Olasagasti,ESP,MF,Real Sociedad,es  La Liga,24-207,2000.0,5.7,15,7,5,6,4,6,15,40.0,9,6,1,5,10,25,6,0
1883,Ben Old,NZL,"MF,FW",Saint-Étienne,fr  Ligue 1,22-210,2002.0,4.2,4,4,3,1,0,2,8,25.0,6,5,1,4,1,5,1,0
1884,Finn Ole Becker,GER,MF,Hoffenheim,de  Bundesliga,24-276,2000.0,6.4,9,4,4,5,0,1,4,25.0,3,7,3,4,8,17,13,0
1885,Michael Olise,FRA,"FW,MF",Bayern Munich,de  Bundesliga,23-089,2001.0,17.5,28,16,8,17,3,14,27,51.9,13,18,1,17,6,34,10,2
1886,Brian Oliván,ESP,DF,Espanyol,es  La Liga,30-344,1994.0,11.3,13,10,7,6,0,4,13,30.8,9,6,2,4,10,23,23,0
1887,Lucas Oliveira Rosa,BRA,DF,Valladolid,es  La Liga,24-342,2000.0,21.0,53,33,40,11,2,35,51,68.6,16,24,9,15,28,81,69,2
1888,Mathías Olivera,URU,DF,Napoli,it  Serie A,27-131,1997.0,17.5,48,28,22,21,5,25,38,65.8,13,26,7,19,23,71,41,0
1889,Dani Olmo,ESP,"MF,FW",Barcelona,es  La Liga,26-308,1998.0,9.0,14,9,8,4,2,3,11,27.3,8,5,3,2,1,15,9,1
1890,Robin Olsen,SWE,GK,Aston Villa,eng  Premier League,35-062,1990.0,2.0,1,0,1,0,0,1,1,100.0,0,0,0,0,0,1,2,1
1891,Warmed Omari,COM,DF,Lyon,fr  Ligue 1,24-322,2000.0,0.1,0,0,0,0,0,0,0,,0,0,0,0,0,0,1,0
1892,Becir Omeragic,SUI,"DF,MF",Montpellier,fr  Ligue 1,23-050,2002.0,14.0,19,8,13,5,1,10,15,66.7,5,24,15,9,9,28,48,0
1893,Jonas Omlin,SUI,GK,Gladbach,de  Bundesliga,31-060,1994.0,5.1,0,0,0,0,0,0,0,,0,0,0,0,0,0,0,0
1894,Andrew Omobamidele,IRL,DF,Strasbourg,fr  Ligue 1,22-261,2002.0,2.7,4,3,2,2,0,1,3,33.3,2,4,3,1,3,7,20,0
1895,Ado Onaiwu,JPN,"MF,FW",Auxerre,fr  Ligue 1,29-123,1995.0,7.0,6,5,1,5,0,2,6,33.3,4,3,0,3,2,8,10,0
1896,Amadou Onana,BEL,MF,Aston Villa,eng  Premier League,23-207,2001.0,12.0,38,22,18,17,3,11,21,52.4,10,13,6,7,19,57,26,3
1897,André Onana,CMR,GK,Manchester Utd,eng  Premier League,28-343,1996.0,28.0,1,1,1,0,0,1,3,33.3,2,0,0,0,0,1,10,4
1898,Jean Onana,CMR,MF,Genoa,it  Serie A,25-062,2000.0,0.5,1,1,0,1,0,1,2,50.0,1,1,0,1,1,2,2,0
1899,Jacob Ondrejka,SWE,"MF,FW",Parma,it  Serie A,22-190,2002.0,0.7,1,0,0,1,0,1,1,100.0,0,0,0,0,1,2,1,0
1900,Karim Onisiwo,AUT,"MF,FW",Mainz 05,de  Bundesliga,32-359,1992.0,1.2,1,1,0,0,1,0,0,,0,0,0,0,0,1,0,0
1901,Paul Onuachu,NGA,FW,Southampton,eng  Premier League,30-287,1994.0,8.0,5,1,1,4,0,2,5,40.0,3,3,1,2,1,6,11,0
1902,Frank Onyeka,NGA,MF,Brentford,eng  Premier League,27-069,1998.0,0.3,0,0,0,0,0,0,0,,0,0,0,0,0,0,0,0
1903,Frank Onyeka,NGA,MF,Augsburg,de  Bundesliga,27-069,1998.0,20.4,43,36,14,23,6,15,30,50.0,15,25,8,17,29,72,29,1
1904,Loïs Openda,BEL,"FW,MF",RB Leipzig,de  Bundesliga,25-023,2000.0,20.5,7,3,2,4,1,2,6,33.3,4,16,1,15,4,11,10,0
1905,Christopher Operi,CIV,"DF,FW",Le Havre,fr  Ligue 1,27-316,1997.0,13.0,13,9,6,2,5,7,12,58.3,5,20,6,14,14,27,30,0
1906,Fredrik Oppegard,NOR,"DF,MF",Auxerre,fr  Ligue 1,22-216,2002.0,0.3,3,3,2,0,1,3,5,60.0,2,0,0,0,0,3,2,0
1907,Victor Orakpo,NGA,FW,Nice,fr  Ligue 1,18-270,2006.0,0.4,0,0,0,0,0,0,0,,0,0,0,0,0,0,0,0
1908,Ike Orazi,IRL,MF,Reims,fr  Ligue 1,17-273,2007.0,0.0,0,0,0,0,0,0,0,,0,0,0,0,0,0,0,0
1909,Gift Orban,NGA,"FW,DF",Lyon,fr  Ligue 1,22-237,2002.0,2.1,0,0,0,0,0,0,1,0.0,1,0,0,0,0,0,0,0
1910,Gift Orban,NGA,FW,Hoffenheim,de  Bundesliga,22-237,2002.0,5.8,3,1,2,1,0,1,6,16.7,5,4,0,4,0,3,3,0
1911,Willi Orban,HUN,DF,RB Leipzig,de  Bundesliga,32-128,1992.0,21.7,35,20,21,13,1,21,29,72.4,8,38,27,11,19,54,148,3
1912,Ivan Ordets,UKR,DF,Bochum,de  Bundesliga,32-246,1992.0,14.7,12,5,9,3,0,7,9,77.8,2,18,8,10,34,46,92,2
1913,Lewis Orford,ENG,MF,West Ham,eng  Premier League,19-021,2006.0,0.5,0,0,0,0,0,0,0,,0,1,0,1,1,1,0,0
1914,Gaetano Oristanio,ITA,"MF,FW",Venezia,it  Serie A,22-164,2002.0,21.6,13,9,4,5,4,4,11,36.4,7,15,0,15,6,19,6,0
1915,Aimar Oroz,ESP,MF,Osasuna,es  La Liga,23-104,2001.0,22.2,23,13,9,9,5,9,31,29.0,22,25,2,23,16,39,5,0
1916,Riccardo Orsolini,ITA,FW,Bologna,it  Serie A,28-046,1997.0,13.6,7,6,1,4,2,2,6,33.3,4,19,0,19,5,12,9,0
1917,Stefan Ortega,GER,GK,Manchester City,eng  Premier League,32-125,1992.0,9.0,0,0,0,0,0,0,1,0.0,1,0,0,0,0,0,8,1
1918,Ángel Ortíz,ESP,DF,Betis,es  La Liga,20-229,2004.0,3.8,10,7,7,3,0,6,15,40.0,9,6,0,6,5,15,7,0
1919,Gabriel Osei Misehouy,NED,"FW,MF",Girona,es  La Liga,19-236,2005.0,2.7,1,1,0,1,0,0,1,0.0,1,0,0,0,0,1,0,0
1920,Gabriel Osho,NGA,DF,Auxerre,fr  Ligue 1,26-209,1998.0,15.4,16,10,12,3,1,8,14,57.1,6,28,16,12,12,28,67,0
1921,Yordan Osorio,VEN,DF,Parma,it  Serie A,30-305,1994.0,1.9,5,3,4,1,0,2,2,100.0,0,3,1,2,4,9,6,1
1922,Patrick Osterhage,GER,MF,Freiburg,de  Bundesliga,25-038,2000.0,17.4,35,25,13,21,1,11,21,52.4,10,19,2,17,17,52,27,0
1923,William Osula,DEN,FW,Newcastle Utd,eng  Premier League,21-219,2003.0,0.8,1,0,0,0,1,0,1,0.0,1,0,0,0,1,2,1,0
1924,Jibril Othman,TUN,FW,Saint-Étienne,fr  Ligue 1,20-319,2004.0,0.1,0,0,0,0,0,0,0,,0,0,0,0,0,0,0,0
1925,David Otorbi,ESP,MF,Valencia,es  La Liga,17-146,2007.0,0.2,0,0,0,0,0,0,0,,0,1,0,1,0,0,0,0
1926,Dango Ouattara,BFA,FW,Bournemouth,eng  Premier League,23-028,2002.0,16.8,29,23,10,10,9,15,33,45.5,18,26,8,18,7,36,39,0
1927,Guimissongui Ouattara,FRA,"FW,DF",Strasbourg,fr  Ligue 1,19-140,2005.0,4.2,6,4,3,1,2,3,5,60.0,2,8,0,8,4,10,10,2
1928,Kassoum Ouattara,FRA,"DF,FW",Monaco,fr  Ligue 1,20-148,2004.0,4.3,9,7,5,4,0,4,14,28.6,10,6,0,6,5,14,2,1
1929,Remi Oudin,FRA,"MF,FW",Lecce,it  Serie A,28-113,1996.0,3.3,3,1,1,1,1,2,4,50.0,2,6,2,4,2,5,1,0
1930,Assan Ouedraogo,GER,MF,RB Leipzig,de  Bundesliga,18-306,2006.0,0.6,0,0,0,0,0,0,0,,0,1,0,1,0,0,0,0
1931,Zinédine Ould Khaled,FRA,MF,Angers,fr  Ligue 1,25-056,2000.0,0.6,1,1,1,0,0,0,1,0.0,1,2,0,2,0,1,1,0
1932,Cheick Oumar Conde,GUI,MF,Venezia,it  Serie A,24-228,2000.0,0.2,3,3,1,1,1,1,1,100.0,0,2,1,1,0,3,1,0
1933,Jesús Owono,EQG,GK,Alavés,es  La Liga,24-010,2001.0,4.4,1,1,1,0,0,1,1,100.0,0,0,0,0,0,1,1,0
1934,Beres Owusu,FRA,DF,Saint-Étienne,fr  Ligue 1,21-173,2003.0,1.0,2,2,1,1,0,2,2,100.0,0,2,2,0,0,2,5,0
1935,Elisha Owusu,GHA,MF,Auxerre,fr  Ligue 1,27-124,1997.0,22.9,67,37,26,36,5,29,44,65.9,15,29,8,21,39,106,33,1
1936,Mikel Oyarzabal,ESP,"FW,MF",Real Sociedad,es  La Liga,27-324,1997.0,16.5,15,9,4,7,4,7,14,50.0,7,9,1,8,4,19,11,0
1937,Daniel Oyegoke,ENG,DF,Hellas Verona,it  Serie A,22-067,2003.0,1.1,2,2,1,0,1,1,1,100.0,0,0,0,0,1,3,7,0
1938,Salih Özcan,TUR,MF,Wolfsburg,de  Bundesliga,27-059,1998.0,3.9,2,2,1,0,1,1,5,20.0,4,5,1,4,7,9,5,0
1939,Salih Özcan,TUR,MF,Dortmund,de  Bundesliga,27-059,1998.0,1.8,5,5,1,3,1,2,3,66.7,1,4,0,4,3,8,2,0
1940,Cenk Özkacar,TUR,DF,Valladolid,es  La Liga,24-156,2000.0,2.9,4,3,3,1,0,2,6,33.3,4,4,2,2,10,14,23,1
1941,Nico O’Reilly,ENG,"MF,DF",Manchester City,eng  Premier League,19-355,2005.0,0.3,2,0,0,2,0,0,0,,0,0,0,0,0,2,1,0
1942,Jon Pacheco,ESP,DF,Real Sociedad,es  La Liga,24-062,2001.0,7.0,10,6,7,3,0,6,8,75.0,2,7,6,1,6,16,36,1
1943,Willian Pacho,ECU,DF,Paris S-G,fr  Ligue 1,23-146,2001.0,19.0,50,30,30,20,0,22,30,73.3,8,28,18,10,32,82,74,1
1944,Daniele Padelli,ITA,GK,Udinese,it  Serie A,39-137,1985.0,1.0,0,0,0,0,0,0,1,0.0,1,0,0,0,0,0,0,0
1945,Alex Padilla,ESP,GK,Athletic Club,es  La Liga,21-191,2003.0,3.6,0,0,0,0,0,0,0,,0,0,0,0,0,0,2,1
1946,Simone Pafundi,ITA,MF,Udinese,it  Serie A,19-025,2006.0,0.4,3,3,2,0,1,1,1,100.0,0,0,0,0,0,3,1,0
1947,Exequiel Palacios,ARG,MF,Leverkusen,de  Bundesliga,26-157,1998.0,7.2,14,10,4,6,4,6,12,50.0,6,9,1,8,8,22,6,0
1948,Tiago Palacios,ARG,DF,Monza,it  Serie A,21-317,2003.0,3.1,3,1,2,1,0,2,6,33.3,4,3,1,2,3,6,9,1
1949,Tiago Palacios,ARG,DF,Inter,it  Serie A,21-317,2003.0,0.1,0,0,0,0,0,0,0,,0,0,0,0,1,1,0,0
1950,Isaac Palazón Camacho,ESP,"FW,MF",Rayo Vallecano,es  La Liga,30-074,1994.0,17.3,20,16,9,6,5,6,24,25.0,18,14,1,13,8,28,10,1
1951,Alberto Paleari,ITA,GK,Torino,it  Serie A,32-194,1992.0,1.0,0,0,0,0,0,0,0,,0,0,0,0,0,0,2,0
1952,Marco Palestra,ITA,DF,Atalanta,it  Serie A,20-008,2005.0,1.2,5,4,3,2,0,3,3,100.0,0,2,0,2,0,5,3,0
1953,João Palhinha,POR,MF,Bayern Munich,de  Bundesliga,29-245,1995.0,5.8,15,12,4,8,3,8,12,66.7,4,10,1,9,4,19,7,1
1954,Nicolas Pallois,FRA,DF,Nantes,fr  Ligue 1,37-173,1987.0,17.0,50,20,35,12,3,31,52,59.6,21,40,14,26,22,72,133,3
1955,Alex Palmer,ENG,GK,Ipswich Town,eng  Premier League,28-213,1996.0,4.0,0,0,0,0,0,0,0,,0,0,0,0,0,0,2,0
1956,Cole Palmer,ENG,MF,Chelsea,eng  Premier League,22-309,2002.0,27.1,21,12,11,5,5,7,18,38.9,11,14,1,13,7,28,12,1
1957,Emerson Palmieri,ITA,DF,West Ham,eng  Premier League,30-220,1994.0,18.9,49,26,31,15,3,20,35,57.1,15,26,6,20,18,67,45,0
1958,Mats Pannewig,GER,MF,Bochum,de  Bundesliga,20-134,2004.0,1.4,3,2,2,1,0,1,7,14.3,6,5,1,4,1,4,4,0
1959,Lucas Paquetá,BRA,"MF,FW",West Ham,eng  Premier League,27-196,1997.0,19.2,51,31,18,24,9,20,37,54.1,17,24,3,21,12,63,23,3
1960,Aitor Paredes,ESP,DF,Athletic Club,es  La Liga,24-316,2000.0,14.2,10,8,7,3,0,4,9,44.4,5,17,8,9,18,28,85,4
1961,Leandro Paredes,ARG,MF,Roma,it  Serie A,30-255,1994.0,11.6,23,12,9,10,4,15,28,53.6,13,11,3,8,16,39,23,1
1962,Daniel Parejo,ESP,MF,Villarreal,es  La Liga,35-329,1989.0,17.8,36,30,21,11,4,18,38,47.4,20,15,3,12,16,52,24,1
1963,Fabiano Parisi,ITA,"DF,MF",Fiorentina,it  Serie A,24-122,2000.0,7.5,15,10,5,6,4,7,13,53.8,6,10,2,8,11,26,13,0
1964,Thomas Partey,GHA,"MF,DF",Arsenal,eng  Premier League,31-271,1993.0,23.3,74,46,22,32,20,39,60,65.0,21,19,6,13,27,101,37,4
1965,Mario Pašalić,CRO,MF,Atalanta,it  Serie A,30-030,1995.0,16.2,22,14,8,12,2,9,22,40.9,13,17,4,13,12,34,23,1
1966,Álvaro Pascual,ESP,FW,Sevilla,es  La Liga,23-069,2002.0,0.7,1,0,0,0,1,1,2,50.0,1,0,0,0,2,3,0,0
1967,Felix Passlack,GER,"DF,MF",Bochum,de  Bundesliga,26-286,1998.0,19.5,40,19,23,12,5,24,46,52.2,22,34,9,25,13,53,47,1
1968,Patric,ESP,DF,Lazio,it  Serie A,31-328,1993.0,6.7,9,6,6,3,0,6,10,60.0,4,3,2,1,3,12,22,1
1969,Rui Patrício,POR,GK,Atalanta,it  Serie A,37-024,1988.0,2.0,0,0,0,0,0,0,0,,0,0,0,0,0,0,3,0
1970,Nathan Patterson,SCO,"DF,FW",Everton,eng  Premier League,23-146,2001.0,1.4,3,1,1,2,0,1,4,25.0,3,2,0,2,0,3,3,0
1971,Benjamin Pavard,FRA,DF,Inter,it  Serie A,28-348,1996.0,14.4,27,15,10,12,5,16,21,76.2,5,12,8,4,14,41,31,0
1972,Aleksandar Pavlovic,GER,MF,Bayern Munich,de  Bundesliga,20-312,2004.0,11.6,30,16,9,13,8,18,27,66.7,9,17,3,14,3,33,9,0
1973,Strahinja Pavlović,SRB,DF,Milan,it  Serie A,23-291,2001.0,13.0,34,20,22,12,0,16,29,55.2,13,9,5,4,10,44,49,0
1974,Leonardo Pavoletti,ITA,"FW,MF",Cagliari,it  Serie A,36-105,1988.0,3.4,0,0,0,0,0,0,0,,0,2,1,1,0,0,1,0
1975,Martín Payero,ARG,MF,Udinese,it  Serie A,26-181,1998.0,11.4,16,10,1,9,6,7,15,46.7,8,8,1,7,10,26,11,0
1976,Nicolas Pays,FRA,"FW,MF",Montpellier,fr  Ligue 1,21-216,2003.0,1.3,3,2,0,2,1,1,1,100.0,0,0,0,0,2,5,1,0
1977,Nicolás Paz,ARG,"MF,FW",Como,it  Serie A,20-184,2004.0,22.0,36,22,13,17,6,18,37,48.6,19,37,2,35,18,54,12,0
1978,Mads Pedersen,DEN,DF,Augsburg,de  Bundesliga,28-191,1996.0,2.6,6,5,4,1,1,3,4,75.0,1,4,0,4,2,8,5,0
1979,Marcus Pedersen,NOR,DF,Torino,it  Serie A,24-238,2000.0,12.7,9,5,4,4,1,7,12,58.3,5,10,2,8,12,21,32,1
1980,Alfonso Pedraza,ESP,"DF,MF",Villarreal,es  La Liga,28-336,1996.0,0.2,0,0,0,0,0,0,0,,0,0,0,0,0,0,0,0
1981,Pedri,ESP,MF,Barcelona,es  La Liga,22-106,2002.0,21.4,40,22,11,22,7,16,47,34.0,31,33,2,31,15,55,17,1
1982,Pedro,ESP,"FW,MF",Lazio,it  Serie A,37-226,1987.0,8.3,15,10,3,8,4,9,17,52.9,8,6,0,6,3,18,2,1
1983,Kévin Pedro,FRA,DF,Saint-Étienne,fr  Ligue 1,19-018,2006.0,0.1,3,0,2,1,0,3,3,100.0,0,1,0,1,2,5,1,0
1984,Adrià Pedrosa,ESP,DF,Sevilla,es  La Liga,26-302,1998.0,17.9,39,25,26,8,5,22,40,55.0,18,32,7,25,14,53,58,0
1985,Jordan Pefok,USA,FW,Union Berlin,de  Bundesliga,28-319,1996.0,10.1,11,6,6,0,5,3,7,42.9,4,9,2,7,4,15,18,0
1986,Pejiño,ESP,FW,Las Palmas,es  La Liga,28-225,1996.0,0.2,1,1,0,1,0,1,1,100.0,0,0,0,0,0,1,0,0
1987,Pietro Pellegri,ITA,FW,Empoli,it  Serie A,23-359,2001.0,4.6,7,2,0,6,1,2,4,50.0,2,2,0,2,0,7,3,0
1988,Lorenzo Pellegrini,ITA,MF,Roma,it  Serie A,28-265,1996.0,15.4,20,14,4,11,5,6,14,42.9,8,7,1,6,5,25,18,0
1989,Luca Pellegrini,ITA,DF,Lazio,it  Serie A,26-004,1999.0,6.1,12,7,5,6,1,8,14,57.1,6,7,1,6,12,24,15,0
1990,Mateo Pellegrino,ARG,FW,Parma,it  Serie A,24-010,2001.0,0.6,0,0,0,0,0,0,0,,0,0,0,0,0,0,0,0
1991,Théo Pellenard,FRA,DF,Auxerre,fr  Ligue 1,31-007,1994.0,0.5,3,2,2,1,0,1,3,33.3,2,1,0,1,0,3,3,0
1992,Andy Pelmard,FRA,DF,Lecce,it  Serie A,24-364,2000.0,1.4,6,6,5,1,0,4,4,100.0,0,1,0,1,0,6,5,0
1993,Andy Pelmard,FRA,DF,Las Palmas,es  La Liga,24-364,2000.0,2.3,5,0,3,2,0,4,5,80.0,1,3,1,2,2,7,20,0
1994,Timothee Pembele,FRA,DF,Le Havre,fr  Ligue 1,22-183,2002.0,7.7,13,9,7,5,1,4,8,50.0,4,13,4,9,5,18,28,0
1995,Faris Pemi Moumbagna,CMR,FW,Marseille,fr  Ligue 1,24-253,2000.0,0.1,0,0,0,0,0,0,0,,0,0,0,0,0,0,0,0
1996,Iñaki Peña,ESP,GK,Barcelona,es  La Liga,26-009,1999.0,14.5,0,0,0,0,0,0,2,0.0,2,0,0,0,0,0,20,1
1997,Rubén Peña,ESP,"FW,DF",Osasuna,es  La Liga,33-236,1991.0,7.1,8,2,2,2,4,2,17,11.8,15,9,0,9,5,13,10,0
1998,Nicolas Pépé,CIV,"FW,MF",Villarreal,es  La Liga,29-286,1995.0,9.5,7,2,1,3,3,1,5,20.0,4,6,1,5,3,10,5,0
1999,Peque,ESP,"FW,MF",Sevilla,es  La Liga,22-158,2002.0,8.9,10,3,4,5,1,4,12,33.3,8,11,0,11,7,17,4,0
2000,Óscar Perea,COL,MF,Strasbourg,fr  Ligue 1,19-165,2005.0,0.1,0,0,0,0,0,0,0,,0,0,0,0,0,0,0,0
2001,Andreas Pereira,BRA,MF,Fulham,eng  Premier League,29-069,1996.0,16.5,18,8,6,9,3,8,34,23.5,26,13,1,12,7,25,13,1
2002,Mathias Pereira Lage,POR,"FW,MF",Brest,fr  Ligue 1,28-101,1996.0,9.3,20,14,8,7,5,8,17,47.1,9,11,1,10,11,31,16,1
2003,Pedro Pereira,POR,DF,Monza,it  Serie A,27-048,1998.0,21.1,29,20,15,11,3,17,31,54.8,14,17,7,10,12,41,54,2
2004,Ricardo Pereira,POR,DF,Leicester City,eng  Premier League,31-156,1993.0,1.7,3,2,0,1,2,1,4,25.0,3,3,1,2,1,4,3,0
2005,Gastón Pereiro,URU,MF,Genoa,it  Serie A,29-273,1995.0,0.3,1,0,0,1,0,1,1,100.0,0,0,0,0,0,1,1,0
2006,Daniel Peretz,ISR,GK,Bayern Munich,de  Bundesliga,24-244,2000.0,3.0,0,0,0,0,0,0,1,0.0,1,0,0,0,0,0,2,0
2007,Ayoze Pérez,ESP,FW,Villarreal,es  La Liga,31-225,1993.0,13.0,18,10,4,11,3,5,17,29.4,12,11,0,11,4,22,9,0
2008,Carles Pérez,ESP,"MF,FW",Getafe,es  La Liga,27-023,1998.0,14.3,29,21,11,12,6,20,47,42.6,27,15,1,14,6,35,19,0
2009,Francisco Perez,ESP,"FW,MF",Valencia,es  La Liga,22-183,2002.0,4.0,5,5,2,3,0,3,8,37.5,5,7,1,6,2,7,4,0
2010,Kike Pérez,ESP,MF,Venezia,it  Serie A,28-025,1997.0,5.1,22,14,8,7,7,11,24,45.8,13,6,0,6,6,28,5,0
2011,Kike Pérez,ESP,MF,Valladolid,es  La Liga,28-025,1997.0,13.2,37,26,15,19,3,15,26,57.7,11,16,4,12,7,44,18,0
2012,Luis Pérez,ESP,DF,Valladolid,es  La Liga,30-035,1995.0,24.9,37,26,23,9,5,24,37,64.9,13,25,9,16,26,63,71,0
2013,Nehuén Pérez,ARG,DF,Udinese,it  Serie A,24-260,2000.0,2.0,1,1,0,0,1,0,1,0.0,1,2,2,0,1,2,7,0
2014,Simone Perilli,ITA,GK,Hellas Verona,it  Serie A,30-063,1995.0,1.0,0,0,0,0,0,0,0,,0,0,0,0,0,0,1,0
2015,Mattia Perin,ITA,GK,Juventus,it  Serie A,32-121,1992.0,5.0,0,0,0,0,0,0,0,,0,0,0,0,0,0,2,0
2016,Romain Perraud,FRA,DF,Betis,es  La Liga,27-170,1997.0,15.7,27,17,11,12,4,16,37,43.2,21,14,3,11,18,45,51,1
2017,Lucas Perri,BRA,GK,Lyon,fr  Ligue 1,27-091,1997.0,25.0,1,1,1,0,0,0,4,0.0,4,1,0,1,0,1,16,1
2018,Gaëtan Perrin,FRA,"MF,FW",Auxerre,fr  Ligue 1,28-277,1996.0,21.0,44,24,21,10,13,20,39,51.3,19,10,0,10,11,55,4,0
2019,Máximo Perrone,ARG,MF,Como,it  Serie A,22-063,2003.0,14.0,27,18,13,9,5,9,30,30.0,21,11,1,10,12,39,27,0
2020,Noah Pesch,CRO,FW,Gladbach,de  Bundesliga,19-297,2005.0,0.1,1,0,0,0,1,0,0,,0,0,0,0,0,1,0,0
2021,Matteo Pessina,ITA,MF,Monza,it  Serie A,27-324,1997.0,9.5,15,4,3,11,1,9,14,64.3,5,6,0,6,12,27,7,0
2022,Andrea Petagna,ITA,FW,Monza,it  Serie A,29-254,1995.0,2.9,1,0,0,1,0,1,2,50.0,1,0,0,0,1,2,2,0
2023,Léo Pétrot,FRA,DF,Saint-Étienne,fr  Ligue 1,27-330,1997.0,20.3,48,29,29,16,3,27,37,73.0,10,34,17,17,32,80,76,0
2024,Đorđe Petrović,SRB,GK,Strasbourg,fr  Ligue 1,25-154,1999.0,22.0,1,1,1,0,0,0,0,,0,0,0,0,0,1,17,0
2025,Giuseppe Pezzella,ITA,"DF,FW",Empoli,it  Serie A,27-102,1997.0,23.0,39,24,24,11,4,25,49,51.0,24,25,7,18,11,50,81,1
2026,Valentín Pezzolesi,ESP,DF,Las Palmas,es  La Liga,17-329,2007.0,0.1,0,0,0,0,0,0,0,,0,0,0,0,0,0,1,1
2027,Luca Philipp,GER,GK,Hoffenheim,de  Bundesliga,24-103,2000.0,5.0,1,0,1,0,0,1,1,100.0,0,0,0,0,0,1,1,0
2028,Maximilian Philipp,GER,"MF,FW",Freiburg,de  Bundesliga,31-010,1994.0,0.2,0,0,0,0,0,0,0,,0,0,0,0,0,0,0,0
2029,Kalvin Phillips,ENG,MF,Ipswich Town,eng  Premier League,29-099,1995.0,12.4,32,17,7,18,7,15,36,41.7,21,31,6,25,19,51,33,2
2030,Jaden Philogene Bidace,ENG,"FW,MF",Aston Villa,eng  Premier League,23-031,2002.0,3.7,11,5,4,7,0,4,6,66.7,2,5,0,5,3,14,2,1
2031,Jaden Philogene Bidace,ENG,"FW,DF",Ipswich Town,eng  Premier League,23-031,2002.0,4.2,13,7,6,5,2,8,15,53.3,7,7,1,6,9,22,8,1
2032,Pica,ESP,DF,Alavés,es  La Liga,23-069,2002.0,5.4,9,7,7,2,0,4,9,44.4,5,7,6,1,8,17,23,0
2033,Roberto Piccoli,ITA,FW,Cagliari,it  Serie A,24-043,2001.0,26.1,13,9,2,6,5,3,6,50.0,3,10,3,7,2,15,26,0
2034,Benedikt Pichler,AUT,FW,Holstein Kiel,de  Bundesliga,27-234,1997.0,8.3,5,2,1,0,4,2,4,50.0,2,4,2,2,2,7,11,0
2035,Jordan Pickford,ENG,GK,Everton,eng  Premier League,31-004,1994.0,28.0,1,0,1,0,0,1,2,50.0,1,0,0,0,1,2,25,1
2036,Amos Pieper,GER,DF,Werder Bremen,de  Bundesliga,27-053,1998.0,8.0,14,7,8,3,3,9,18,50.0,9,15,9,6,16,30,35,0
2037,Marvin Pieringer,GER,"FW,MF",Heidenheim,de  Bundesliga,25-158,1999.0,16.4,17,10,5,8,4,3,5,60.0,2,17,2,15,6,23,23,0
2038,Nicholas Pierini,ITA,MF,Venezia,it  Serie A,26-217,1998.0,0.9,0,0,0,0,0,0,1,0.0,1,2,0,2,0,0,0,0
2039,Santiago Pierotti,ARG,FW,Lecce,it  Serie A,23-342,2001.0,15.5,32,20,15,13,4,16,37,43.2,21,18,5,13,9,41,24,0
2040,Balthazar Pierret,FRA,MF,Lecce,it  Serie A,24-300,2000.0,14.5,40,25,20,18,2,8,23,34.8,15,15,4,11,15,55,31,1
2041,Andrea Pinamonti,ITA,FW,Genoa,it  Serie A,25-296,1999.0,24.0,8,5,0,6,2,0,5,0.0,5,11,3,8,1,9,20,2
2042,Ethan Pinnock,JAM,DF,Brentford,eng  Premier League,31-286,1993.0,19.3,33,17,14,15,4,13,22,59.1,9,27,16,11,24,57,126,3
2043,Yeremi Pino,ESP,MF,Villarreal,es  La Liga,22-142,2002.0,14.6,40,21,11,23,6,20,43,46.5,23,27,3,24,6,46,10,0
2044,Niccolò Pisilli,ITA,MF,Roma,it  Serie A,20-169,2004.0,12.1,20,9,10,6,4,11,18,61.1,7,11,3,8,9,29,15,0
2045,Semuel Pizzignacco,ITA,GK,Monza,it  Serie A,23-191,2001.0,4.3,0,0,0,0,0,0,1,0.0,1,0,0,0,0,0,3,0
2046,Alassane Pléa,FRA,"MF,FW",Gladbach,de  Bundesliga,32-001,1993.0,14.6,6,3,0,2,4,3,7,42.9,4,7,0,7,2,8,4,1
2047,Tommaso Pobega,ITA,MF,Bologna,it  Serie A,25-239,1999.0,9.8,26,16,11,10,5,17,23,73.9,6,12,4,8,11,37,12,0
2048,Daniel Podence,POR,"MF,FW",Wolves,eng  Premier League,29-141,1995.0,0.5,0,0,0,0,0,0,1,0.0,1,0,0,0,0,0,0,0
2049,Joel Pohjanpalo,FIN,FW,Venezia,it  Serie A,30-179,1994.0,17.8,3,3,1,2,0,0,4,0.0,4,7,4,3,4,7,24,0
2050,Matteo Politano,ITA,"FW,MF",Napoli,it  Serie A,31-220,1993.0,21.9,22,11,14,8,0,12,34,35.3,22,16,1,15,9,31,37,1
2051,Alfie Pond,ENG,DF,Wolves,eng  Premier League,21-010,2004.0,0.0,0,0,0,0,0,0,0,,0,0,0,0,0,0,0,0
2052,Marin Pongračić,CRO,DF,Fiorentina,it  Serie A,27-181,1997.0,7.2,10,7,6,3,1,5,7,71.4,2,9,5,4,5,15,40,1
2053,Nick Pope,ENG,GK,Newcastle Utd,eng  Premier League,32-326,1992.0,18.0,0,0,0,0,0,0,0,,0,1,0,1,1,1,20,5
2054,Finn Porath,GER,"DF,MF",Holstein Kiel,de  Bundesliga,28-016,1997.0,18.2,39,21,22,12,5,22,46,47.8,24,22,6,16,18,57,57,0
2055,Pedro Porro,ESP,DF,Tottenham,eng  Premier League,25-179,1999.0,25.3,58,42,27,22,9,40,67,59.7,27,39,15,24,32,90,74,1
2056,Portu,ESP,"FW,MF",Girona,es  La Liga,32-294,1992.0,3.4,7,2,2,3,2,5,6,83.3,1,5,0,5,0,7,1,0
2057,Stefan Posch,AUT,DF,Bologna,it  Serie A,27-301,1997.0,7.9,26,15,12,9,5,15,25,60.0,10,19,4,15,5,31,22,0
2058,Stefan Posch,AUT,DF,Atalanta,it  Serie A,27-301,1997.0,3.8,14,10,5,6,3,7,8,87.5,1,5,1,4,4,18,13,0
2059,Tom Pouilly,FRA,DF,Lens,fr  Ligue 1,21-266,2003.0,0.7,2,2,1,1,0,1,2,50.0,1,2,1,1,1,3,4,0
2060,Yussuf Poulsen,DEN,"FW,MF",RB Leipzig,de  Bundesliga,30-269,1994.0,3.1,9,5,2,5,2,3,6,50.0,3,5,2,3,0,9,10,0
2061,Beñat Prados,ESP,MF,Athletic Club,es  La Liga,24-031,2001.0,13.1,28,17,9,13,6,9,28,32.1,19,17,2,15,22,50,22,0
2062,Alexander Prass,AUT,DF,Hoffenheim,de  Bundesliga,23-289,2001.0,16.9,41,23,23,15,3,24,57,42.1,33,32,6,26,9,50,48,4
2063,Matteo Prati,ITA,MF,Cagliari,it  Serie A,21-073,2003.0,3.0,6,2,1,4,1,2,6,33.3,4,1,0,1,2,8,3,1
2064,Abdón Prats,ESP,"FW,MF",Mallorca,es  La Liga,32-094,1992.0,2.8,1,1,1,0,0,0,1,0.0,1,2,1,1,1,2,3,0
2065,Grischa Prömel,GER,MF,Hoffenheim,de  Bundesliga,30-061,1995.0,1.9,0,0,0,0,0,0,1,0.0,1,1,1,0,2,2,4,0
2066,Ivan Provedel,ITA,GK,Lazio,it  Serie A,30-359,1994.0,27.0,0,0,0,0,0,0,0,,0,1,0,1,1,1,10,3
2067,Ivan Prtajin,CRO,FW,Union Berlin,de  Bundesliga,28-301,1996.0,1.8,3,2,0,1,2,0,0,,0,2,0,2,0,3,3,0
2068,Javi Puado,ESP,"FW,MF",Espanyol,es  La Liga,26-290,1998.0,22.8,15,12,9,3,3,6,11,54.5,5,12,2,10,4,19,13,0
2069,Tymoteusz Puchacz,POL,DF,Holstein Kiel,de  Bundesliga,26-047,1999.0,4.4,9,4,6,3,0,5,7,71.4,2,4,1,3,3,12,11,0
2070,Diego Pugno,ITA,FW,Juventus,it  Serie A,18-247,2006.0,0.1,0,0,0,0,0,0,0,,0,0,0,0,0,0,0,0
2071,Christian Pulisic,USA,"FW,MF",Milan,it  Serie A,26-174,1998.0,18.2,28,17,9,10,9,10,26,38.5,16,16,1,15,3,31,7,1
2072,Jarell Quansah,ENG,DF,Liverpool,eng  Premier League,22-041,2003.0,3.2,9,7,7,2,0,4,5,80.0,1,4,4,0,5,14,13,0
2073,Leopold Querfeld,AUT,DF,Union Berlin,de  Bundesliga,21-081,2003.0,10.4,13,5,10,3,0,6,10,60.0,4,15,6,9,9,22,65,1
2074,Dani Raba,ESP,"FW,MF",Leganés,es  La Liga,29-133,1995.0,12.6,27,16,13,11,3,12,27,44.4,15,19,2,17,12,39,12,1
2075,Adrien Rabiot,FRA,MF,Marseille,fr  Ligue 1,29-342,1995.0,18.6,39,23,14,16,9,19,28,67.9,9,15,1,14,17,56,25,0
2076,Ionuț Radu,ROU,GK,Venezia,it  Serie A,27-287,1997.0,5.0,0,0,0,0,0,0,0,,0,0,0,0,0,0,0,0
2077,Hamza Rafia,TUN,MF,Lecce,it  Serie A,25-343,1999.0,11.8,44,27,14,25,5,15,32,46.9,17,7,2,5,4,48,18,1
2078,Hákon Rafn Valdimarsson,ISL,GK,Brentford,eng  Premier League,23-149,2001.0,1.6,0,0,0,0,0,0,0,,0,0,0,0,0,0,2,0
2079,Antonio Raillo,ESP,DF,Mallorca,es  La Liga,33-154,1991.0,25.6,24,14,12,9,3,13,15,86.7,2,32,26,6,27,51,145,1
2080,Antonio Raimondo,ITA,"FW,DF",Venezia,it  Serie A,20-358,2004.0,1.0,2,1,1,1,0,0,0,,0,0,0,0,0,2,0,1
2081,Ylber Ramadani,ALB,MF,Lecce,it  Serie A,28-333,1996.0,16.3,40,23,19,21,0,25,38,65.8,13,25,8,17,20,60,21,3
2082,Benito Ramírez,ESP,"DF,MF",Las Palmas,es  La Liga,29-243,1995.0,4.3,10,5,4,6,0,9,16,56.3,7,6,3,3,1,11,14,1
2083,Sandro Ramírez,ESP,"FW,MF",Las Palmas,es  La Liga,29-245,1995.0,17.2,22,14,9,10,3,12,26,46.2,14,14,0,14,14,36,18,2
2084,Gonçalo Ramos,POR,FW,Paris S-G,fr  Ligue 1,23-264,2001.0,6.5,8,6,4,3,1,2,3,66.7,1,3,1,2,0,8,3,0
2085,Aaron Ramsdale,ENG,GK,Southampton,eng  Premier League,26-301,1998.0,20.0,0,0,0,0,0,0,2,0.0,2,0,0,0,2,2,8,2
2086,Jacob Ramsey,ENG,"FW,MF",Aston Villa,eng  Premier League,23-287,2001.0,13.9,20,11,10,8,2,7,15,46.7,8,18,3,15,7,27,6,1
2087,Luca Ranieri,ITA,DF,Fiorentina,it  Serie A,25-322,1999.0,25.7,26,15,19,6,1,12,16,75.0,4,35,23,12,19,45,108,1
2088,Grant Ranos,ARM,FW,Gladbach,de  Bundesliga,21-234,2003.0,0.2,1,0,0,1,0,0,1,0.0,1,2,0,2,0,1,0,0
2089,Lilian Raolisoa,FRA,"DF,FW",Angers,fr  Ligue 1,24-268,2000.0,8.8,26,15,15,9,2,9,22,40.9,13,7,2,5,10,36,35,0
2090,Raphinha,BRA,"FW,MF",Barcelona,es  La Liga,28-087,1996.0,23.6,29,20,6,16,7,15,29,51.7,14,20,2,18,6,35,20,0
2091,Marcus Rashford,ENG,"FW,MF",Manchester Utd,eng  Premier League,27-131,1997.0,10.9,7,4,2,2,3,3,9,33.3,6,8,0,8,4,11,7,0
2092,Marcus Rashford,ENG,FW,Aston Villa,eng  Premier League,27-131,1997.0,2.2,6,3,0,1,5,2,3,66.7,1,2,0,2,0,6,3,0
2093,Giacomo Raspadori,ITA,"FW,MF",Napoli,it  Serie A,25-021,2000.0,7.3,9,4,4,5,0,5,7,71.4,2,9,2,7,2,11,5,0
2094,Andrei Ratiu,ROU,DF,Rayo Vallecano,es  La Liga,26-264,1998.0,24.2,53,30,33,13,7,30,49,61.2,19,29,3,26,19,72,52,2
2095,Raúl,ESP,"FW,MF",Osasuna,es  La Liga,24-128,2000.0,6.6,9,4,2,4,3,4,7,57.1,3,3,0,3,0,9,3,0
2096,David Raum,GER,DF,RB Leipzig,de  Bundesliga,26-323,1998.0,14.9,24,18,11,8,5,10,21,47.6,11,19,5,14,8,32,32,0
2097,Federico Ravaglia,ITA,GK,Bologna,it  Serie A,25-120,1999.0,8.0,0,0,0,0,0,0,0,,0,0,0,0,0,0,3,0
2098,Rayan Raveloson,MAD,"MF,DF",Auxerre,fr  Ligue 1,28-054,1997.0,8.0,6,5,2,4,0,5,15,33.3,10,8,7,1,5,11,22,0
2099,David Raya,ESP,GK,Arsenal,eng  Premier League,29-177,1995.0,28.0,0,0,0,0,0,0,1,0.0,1,0,0,0,2,2,13,4
2100,Abderrahman Rebbach,ALG,"FW,MF",Alavés,es  La Liga,26-212,1998.0,4.3,3,2,3,0,0,0,6,0.0,6,4,0,4,0,3,6,0
2101,Ante Rebić,CRO,"FW,MF",Lecce,it  Serie A,31-171,1993.0,6.6,9,7,5,2,2,2,7,28.6,5,4,1,3,1,10,3,0
2102,Harrison Reed,ENG,MF,Fulham,eng  Premier League,30-043,1995.0,0.9,5,2,2,2,1,0,2,0.0,2,1,0,1,1,6,2,0
2103,Remy Rees-Dottin,ENG,FW,Bournemouth,eng  Premier League,19-005,2006.0,0.0,0,0,0,0,0,0,0,,0,0,0,0,0,0,0,0
2104,Sergio Reguilón,ESP,DF,Tottenham,eng  Premier League,28-085,1996.0,1.4,4,3,1,3,0,2,3,66.7,1,4,0,4,2,6,3,0
2105,Bobby Reid,JAM,"FW,MF",Leicester City,eng  Premier League,32-037,1993.0,7.1,8,3,3,5,0,3,13,23.1,10,6,1,5,0,8,8,0
2106,Tijjani Reijnders,NED,MF,Milan,it  Serie A,26-225,1998.0,24.8,18,11,4,10,4,8,19,42.1,11,16,3,13,27,45,19,2
2107,Pepe Reina,ESP,GK,Como,it  Serie A,42-192,1982.0,10.0,0,0,0,0,0,0,1,0.0,1,0,0,0,0,0,3,1
2108,Rocco Reitz,GER,MF,Gladbach,de  Bundesliga,22-286,2002.0,13.9,37,15,15,19,3,16,28,57.1,12,20,7,13,39,76,36,1
2109,Nicolai Remberg,GER,MF,Holstein Kiel,de  Bundesliga,24-265,2000.0,19.2,35,20,18,14,3,15,28,53.6,13,34,13,21,17,52,76,0
2110,Álex Remiro,ESP,GK,Real Sociedad,es  La Liga,29-352,1995.0,26.0,0,0,0,0,0,0,1,0.0,1,0,0,0,0,0,10,4
2111,Devyne Rensch,NED,DF,Roma,it  Serie A,22-052,2003.0,2.9,12,8,4,7,1,6,7,85.7,1,4,2,2,5,17,6,1
2112,Guillaume Restes,FRA,GK,Toulouse,fr  Ligue 1,20-000,2005.0,20.3,2,1,2,0,0,2,2,100.0,0,0,0,0,1,3,13,1
2113,Mateo Retegui,ITA,FW,Atalanta,it  Serie A,25-316,1999.0,17.7,11,6,0,6,5,2,9,22.2,7,3,0,3,2,13,12,0
2114,Elvis Rexhbeçaj,KVX,MF,Augsburg,de  Bundesliga,27-130,1997.0,16.1,24,18,7,13,4,13,32,40.6,19,33,8,25,15,39,17,1
2115,Gio Reyna,USA,MF,Dortmund,de  Bundesliga,22-118,2002.0,3.6,6,0,3,0,3,3,4,75.0,1,3,1,2,0,6,9,0
2116,Chadi Riad,MAR,DF,Crystal Palace,eng  Premier League,21-267,2003.0,1.0,5,2,2,2,1,2,3,66.7,1,0,0,0,2,7,0,0
2117,Alexsandro Ribeiro,BRA,DF,Lille,fr  Ligue 1,25-214,1999.0,22.0,27,16,15,11,1,19,29,65.5,10,17,10,7,24,51,97,1
2118,Samuele Ricci,ITA,MF,Torino,it  Serie A,23-202,2001.0,25.3,29,16,14,10,5,15,21,71.4,6,18,8,10,22,51,42,2
2119,Declan Rice,ENG,MF,Arsenal,eng  Premier League,26-056,1999.0,23.0,39,17,15,18,6,12,30,40.0,18,18,10,8,20,59,32,0
2120,Chris Richards,USA,DF,Crystal Palace,eng  Premier League,24-348,2000.0,14.9,38,25,17,16,5,21,34,61.8,13,26,9,17,9,47,83,0
2121,Amir Richardson,MAR,MF,Fiorentina,it  Serie A,23-046,2002.0,8.0,22,10,11,9,2,8,18,44.4,10,10,1,9,4,26,25,1
2122,Richarlison,BRA,FW,Tottenham,eng  Premier League,27-305,1997.0,3.1,4,3,0,3,1,0,0,,0,1,1,0,0,4,8,0
2123,Diego Rico,ESP,DF,Getafe,es  La Liga,32-016,1993.0,24.0,66,41,42,21,3,35,65,53.8,30,35,3,32,28,94,79,2
2124,Fabian Rieder,SUI,"MF,FW",Stuttgart,de  Bundesliga,23-023,2002.0,7.5,15,12,3,8,4,7,22,31.8,15,8,1,7,6,21,3,1
2125,Luis Rioja,ESP,FW,Alavés,es  La Liga,31-146,1993.0,0.3,2,1,0,1,1,1,2,50.0,1,2,0,2,0,2,0,0
2126,Luis Rioja,ESP,"MF,FW",Valencia,es  La Liga,31-146,1993.0,23.9,25,16,8,12,5,11,33,33.3,22,25,1,24,21,46,34,0
2127,Rodrigo Riquelme,ESP,"DF,MF",Atlético Madrid,es  La Liga,24-343,2000.0,4.6,8,3,3,5,0,4,9,44.4,5,2,0,2,1,9,3,0
2128,Alberto Risco,ESP,"MF,FW",Getafe,es  La Liga,19-193,2005.0,0.8,4,4,2,0,2,1,6,16.7,5,2,0,2,0,4,0,0
2129,Mihailo Ristić,SRB,"MF,DF",Celta Vigo,es  La Liga,29-131,1995.0,2.2,3,3,2,1,0,1,3,33.3,2,0,0,0,1,4,6,0
2130,Lars Ritzka,GER,"DF,MF",St. Pauli,de  Bundesliga,26-308,1998.0,7.7,42,26,23,14,5,21,36,58.3,15,13,2,11,8,50,28,0
2131,Gorka Rivera Alonso,ESP,"DF,MF",Getafe,es  La Liga,20-222,2004.0,0.2,2,0,0,2,0,2,2,100.0,0,0,0,0,0,2,0,0
2132,Sergi Roberto,ESP,MF,Como,it  Serie A,33-032,1992.0,6.9,13,7,5,4,4,5,6,83.3,1,6,1,5,9,22,13,0
2133,Andrew Robertson,SCO,DF,Liverpool,eng  Premier League,31-000,1994.0,22.4,34,21,22,9,3,27,43,62.8,16,9,4,5,19,53,43,1
2134,Antonee Robinson,USA,DF,Fulham,eng  Premier League,27-215,1997.0,27.2,71,45,44,22,5,34,70,48.6,36,31,4,27,47,118,95,0
2135,Marc Roca,ESP,MF,Betis,es  La Liga,28-105,1996.0,10.1,20,14,10,9,1,9,17,52.9,8,17,5,12,14,34,14,2
2136,Rodri,ESP,MF,Manchester City,eng  Premier League,28-262,1996.0,0.7,2,1,1,1,0,0,0,,0,1,0,1,1,3,0,0
2137,Rodri,ESP,FW,Betis,es  La Liga,24-299,2000.0,1.3,2,1,1,1,0,1,2,50.0,1,2,1,1,1,3,1,1
2138,Adrian Rodriguez,ESP,GK,Alavés,es  La Liga,24-089,2000.0,0.4,0,0,0,0,0,0,0,,0,0,0,0,0,0,1,0
2139,Álvaro Rodríguez,URU,FW,Getafe,es  La Liga,20-240,2004.0,6.8,8,5,0,6,2,3,7,42.9,4,20,0,20,3,11,12,0
2140,Óscar Rodríguez Arnaiz,ESP,"MF,FW",Leganés,es  La Liga,26-256,1998.0,11.0,27,13,8,13,6,11,22,50.0,11,8,1,7,13,40,15,0
2141,Damián Rodríguez,ESP,MF,Celta Vigo,es  La Liga,21-359,2003.0,7.9,11,7,3,7,1,5,14,35.7,9,6,1,5,6,17,10,0
2142,Dani Rodríguez,ESP,"MF,FW",Mallorca,es  La Liga,36-278,1988.0,17.7,36,23,12,14,10,12,23,52.2,11,16,2,14,10,46,20,0
2143,Guido Rodríguez,ARG,MF,West Ham,eng  Premier League,30-333,1994.0,11.3,30,16,19,11,0,14,30,46.7,16,21,9,12,12,42,28,1
2144,James Rodríguez,COL,"MF,FW",Rayo Vallecano,es  La Liga,33-242,1991.0,1.6,3,2,1,2,0,0,2,0.0,2,2,0,2,1,4,0,0
2145,Javi Rodríguez,ESP,DF,Celta Vigo,es  La Liga,21-258,2003.0,18.6,41,30,28,13,0,24,36,66.7,12,22,7,15,26,67,71,1
2146,Jesus Rodríguez,ESP,FW,Betis,es  La Liga,19-110,2005.0,7.5,12,10,4,4,4,3,7,42.9,4,12,0,12,5,17,2,0
2147,Kirian Rodríguez,ESP,MF,Las Palmas,es  La Liga,29-006,1996.0,19.5,33,17,12,18,3,22,43,51.2,21,22,4,18,10,43,21,0
2148,Ricardo Rodríguez,SUI,DF,Betis,es  La Liga,32-198,1992.0,9.7,24,12,13,4,7,16,24,66.7,8,7,1,6,6,30,32,0
2149,Rodrygo,BRA,"FW,MF",Real Madrid,es  La Liga,24-061,2001.0,18.3,13,10,9,3,1,4,16,25.0,12,14,1,13,8,21,7,0
2150,Mads Roerslev,DEN,DF,Brentford,eng  Premier League,25-260,1999.0,12.2,18,8,14,3,1,11,28,39.3,17,12,5,7,4,22,35,0
2151,Mads Roerslev,DEN,DF,Wolfsburg,de  Bundesliga,25-260,1999.0,2.8,10,9,8,1,1,6,9,66.7,3,2,2,0,4,14,14,0
2152,Morgan Rogers,ENG,"MF,FW",Aston Villa,eng  Premier League,22-228,2002.0,26.0,25,12,7,10,8,10,28,35.7,18,20,5,15,4,29,17,1
2153,Merlin Röhl,GER,"MF,FW",Freiburg,de  Bundesliga,22-249,2002.0,10.1,16,10,4,10,2,9,11,81.8,2,6,1,5,5,21,2,0
2154,Alessio Romagnoli,ITA,DF,Lazio,it  Serie A,30-058,1995.0,20.7,32,18,14,16,2,15,19,78.9,4,22,10,12,21,53,80,0
2155,Leo Román,ESP,GK,Mallorca,es  La Liga,24-248,2000.0,5.0,0,0,0,0,0,0,0,,0,0,0,0,0,0,0,0
2156,Carlos Romero,ESP,"DF,MF",Espanyol,es  La Liga,23-133,2001.0,16.5,42,27,31,9,2,24,47,51.1,23,22,8,14,14,56,57,1
2157,Cristian Romero,ARG,DF,Tottenham,eng  Premier League,26-318,1998.0,11.5,27,23,22,5,0,15,22,68.2,7,13,3,10,13,40,34,1
2158,Isaac Romero,ESP,FW,Sevilla,es  La Liga,24-297,2000.0,20.0,9,4,2,3,4,1,13,7.7,12,13,1,12,5,14,19,0
2159,Luka Romero,ARG,"FW,MF",Alavés,es  La Liga,20-113,2004.0,2.2,4,4,1,1,2,2,3,66.7,1,2,0,2,1,5,0,0
2160,Oriol Romeu,ESP,MF,Girona,es  La Liga,33-168,1991.0,11.8,31,21,12,16,3,12,21,57.1,9,16,5,11,10,41,12,3
2161,Valentin Rongier,FRA,"MF,DF",Marseille,fr  Ligue 1,30-094,1994.0,10.5,30,18,9,18,3,14,25,56.0,11,22,7,15,22,52,22,2
2162,Marten de Roon,NED,"MF,DF",Atalanta,it  Serie A,33-347,1991.0,25.0,57,34,23,31,3,21,46,45.7,25,28,5,23,32,89,44,1
2163,Vitor Roque,BRA,FW,Betis,es  La Liga,20-011,2005.0,13.7,11,6,1,6,4,1,5,20.0,4,5,0,5,7,18,4,0
2164,Pablo Rosario,NED,"MF,DF",Nice,fr  Ligue 1,28-063,1997.0,14.3,16,10,4,10,2,6,14,42.9,8,13,7,6,24,40,35,2
2165,Lasse Rosenboom,GER,DF,Holstein Kiel,de  Bundesliga,23-051,2002.0,12.0,28,19,16,8,4,20,29,69.0,9,22,8,14,13,41,48,2
2166,Max Rosenfelder,GER,DF,Freiburg,de  Bundesliga,22-029,2003.0,9.4,21,14,14,7,0,11,14,78.6,3,12,8,4,5,26,53,0
2167,Valentin Rosier,FRA,DF,Leganés,es  La Liga,28-204,1996.0,21.1,54,39,38,13,3,32,54,59.3,22,28,10,18,35,89,114,1
2168,Tom Rothe,GER,"DF,MF",Union Berlin,de  Bundesliga,20-133,2004.0,13.6,37,20,23,11,3,25,40,62.5,15,27,3,24,11,48,35,1
2169,Anthony Rouault,FRA,DF,Rennes,fr  Ligue 1,23-286,2001.0,1.8,2,0,2,0,0,1,1,100.0,0,3,3,0,3,5,10,0
2170,Anthony Rouault,FRA,DF,Stuttgart,de  Bundesliga,23-286,2001.0,13.5,15,11,10,3,2,10,15,66.7,5,18,9,9,19,34,63,1
2171,Jonas Rouhi,SWE,DF,Juventus,it  Serie A,21-063,2004.0,2.3,4,1,1,3,0,0,1,0.0,1,2,0,2,3,7,2,0
2172,Jérôme Roussillon,FRA,"DF,MF",Union Berlin,de  Bundesliga,32-064,1993.0,1.2,0,0,0,0,0,0,1,0.0,1,0,0,0,2,2,6,0
2173,Nicolò Rovella,ITA,MF,Lazio,it  Serie A,23-097,2001.0,21.3,58,36,22,29,7,28,57,49.1,29,13,3,10,35,93,29,3
2174,Jon Rowe,ENG,"FW,MF",Marseille,fr  Ligue 1,21-315,2003.0,5.8,9,8,1,2,6,4,7,57.1,3,2,1,1,1,10,1,0
2175,Amir Rrahmani,KVX,DF,Napoli,it  Serie A,31-015,1994.0,28.0,30,24,16,13,1,14,22,63.6,8,31,17,14,16,46,117,1
2176,Tommaso Rubino,ITA,MF,Fiorentina,it  Serie A,18-121,2006.0,0.1,0,0,0,0,0,0,1,0.0,1,0,0,0,0,0,0,0
2177,Antonio Rüdiger,GER,DF,Real Madrid,es  La Liga,32-008,1993.0,21.1,15,9,9,6,0,8,12,66.7,4,20,12,8,8,23,80,1
2178,Matteo Ruggeri,ITA,DF,Atalanta,it  Serie A,22-243,2002.0,16.4,31,19,12,9,10,20,30,66.7,10,23,3,20,15,46,34,1
2179,Aitor Ruibal,ESP,"FW,DF",Betis,es  La Liga,28-354,1996.0,7.5,12,8,7,2,3,8,15,53.3,7,9,2,7,9,21,14,0
2180,Abel Ruiz,ESP,FW,Girona,es  La Liga,25-042,2000.0,12.2,4,1,2,1,1,2,5,40.0,3,5,2,3,4,8,7,0
2181,Ferrán Ruiz,ESP,MF,Girona,es  La Liga,21-319,2003.0,0.2,0,0,0,0,0,0,0,,0,2,1,1,1,1,0,0
2182,Fabián Ruiz Peña,ESP,MF,Paris S-G,fr  Ligue 1,28-342,1996.0,15.8,26,16,12,8,6,14,36,38.9,22,20,2,18,13,39,25,1
2183,Gerónimo Rulli,ARG,GK,Marseille,fr  Ligue 1,32-295,1992.0,25.0,3,2,3,0,0,3,6,50.0,3,1,0,1,0,3,21,2
2184,Georginio Rutter,FRA,"MF,FW",Brighton,eng  Premier League,22-325,2002.0,17.6,37,14,12,17,8,14,36,38.9,22,20,3,17,9,46,13,1
2185,Mathew Ryan,AUS,GK,Lens,fr  Ligue 1,32-337,1992.0,5.0,0,0,0,0,0,0,0,,0,0,0,0,0,0,1,0
2186,Julian Ryerson,NOR,DF,Dortmund,de  Bundesliga,27-114,1997.0,17.2,29,19,18,7,4,19,29,65.5,10,23,2,21,17,46,20,1
2187,Frederik Rønnow,DEN,GK,Union Berlin,de  Bundesliga,32-219,1992.0,20.0,0,0,0,0,0,0,1,0.0,1,0,0,0,0,0,10,2
2188,José Sá,POR,GK,Wolves,eng  Premier League,32-053,1993.0,21.0,2,2,2,0,0,2,2,100.0,0,0,0,0,0,2,13,1
2189,Elias Saad,TUN,"FW,MF",St. Pauli,de  Bundesliga,25-074,1999.0,6.8,19,12,6,8,5,9,18,50.0,9,10,0,10,1,20,1,0
2190,Youssouf Sabaly,SEN,DF,Betis,es  La Liga,32-006,1993.0,14.1,33,23,17,13,3,20,26,76.9,6,14,2,12,11,44,35,0
2191,Emmanuel Sabbi,USA,"FW,MF",Le Havre,fr  Ligue 1,27-077,1997.0,7.3,14,7,7,4,3,5,8,62.5,3,2,0,2,3,17,4,0
2192,Stefano Sabelli,ITA,DF,Genoa,it  Serie A,32-057,1993.0,16.4,48,28,23,21,4,19,44,43.2,25,24,5,19,14,62,51,0
2193,Marcel Sabitzer,AUT,"MF,FW",Dortmund,de  Bundesliga,30-359,1994.0,16.0,26,16,6,14,6,15,25,60.0,10,16,5,11,10,36,29,1
2194,Falaye Sacko,MLI,DF,Montpellier,fr  Ligue 1,29-314,1995.0,10.6,14,8,9,4,1,9,18,50.0,9,16,6,10,11,25,15,0
2195,Umar Sadiq,NGA,FW,Valencia,es  La Liga,28-037,1997.0,4.1,5,2,1,2,2,2,4,50.0,2,2,0,2,0,5,1,0
2196,Umar Sadiq,NGA,FW,Real Sociedad,es  La Liga,28-037,1997.0,2.5,2,1,1,1,0,1,2,50.0,1,3,1,2,1,3,2,0
2197,Alexis Saelemaekers,BEL,"DF,FW",Roma,it  Serie A,25-257,1999.0,9.8,26,13,18,5,3,13,23,56.5,10,10,1,9,6,32,5,0
2198,Alexis Saelemaekers,BEL,"DF,FW",Milan,it  Serie A,25-257,1999.0,1.0,1,1,0,0,1,1,1,100.0,0,0,0,0,1,2,0,0
2199,Jorge Sáenz,ESP,DF,Leganés,es  La Liga,28-114,1996.0,10.9,23,15,10,12,1,6,10,60.0,4,15,10,5,18,41,97,0
2200,Matvei Safonov,RUS,GK,Paris S-G,fr  Ligue 1,26-014,1999.0,6.8,0,0,0,0,0,0,0,,0,1,0,1,1,1,3,0
2201,Modibo Sagnan,MLI,DF,Montpellier,fr  Ligue 1,25-331,1999.0,19.8,49,27,34,12,3,23,40,57.5,17,20,12,8,26,75,98,4
2202,Richie Sagrado,BEL,DF,Venezia,it  Serie A,21-040,2004.0,1.6,2,2,1,1,0,1,1,100.0,0,1,0,1,3,5,4,0
2203,Osame Sahraoui,MAR,"FW,MF",Lille,fr  Ligue 1,23-273,2001.0,11.7,9,7,2,2,5,2,6,33.3,4,11,1,10,6,15,5,1
2204,Wesley Saïd,FRA,"FW,MF",Lens,fr  Ligue 1,29-326,1995.0,7.0,9,6,2,6,1,3,7,42.9,4,2,0,2,0,9,2,0
2205,Théo Sainte-Luce,FRA,DF,Montpellier,fr  Ligue 1,26-142,1998.0,7.2,15,8,12,1,2,11,24,45.8,13,12,4,8,4,19,22,0
2206,Bukayo Saka,ENG,"FW,MF",Arsenal,eng  Premier League,23-187,2001.0,14.1,22,13,5,10,7,9,19,47.4,10,16,0,16,2,24,7,0
2207,Faik Sakar,GER,MF,RB Leipzig,de  Bundesliga,17-056,2008.0,0.0,0,0,0,0,0,0,0,,0,0,0,0,0,0,0,0
2208,Marco Sala,ITA,DF,Como,it  Serie A,25-280,1999.0,2.9,9,6,5,3,1,5,8,62.5,3,2,0,2,1,10,9,0
2209,Marco Sala,ITA,DF,Lecce,it  Serie A,25-280,1999.0,0.3,1,0,0,1,0,0,1,0.0,1,0,0,0,0,1,0,0
2210,Ibrahim Salah,MAR,FW,Brest,fr  Ligue 1,23-193,2001.0,4.0,4,2,1,1,2,1,6,16.7,5,2,0,2,2,6,0,0
2211,Mohamed Salah,EGY,FW,Liverpool,eng  Premier League,32-269,1992.0,28.5,18,11,7,5,6,7,12,58.3,5,4,0,4,4,22,5,0
2212,Anass Salah-Eddine,NED,DF,Roma,it  Serie A,23-052,2002.0,1.7,1,1,1,0,0,0,0,,0,0,0,0,1,2,2,2
2213,Amine Salama,FRA,FW,Reims,fr  Ligue 1,24-236,2000.0,4.1,3,2,0,2,1,0,3,0.0,3,2,1,1,1,4,0,0
2214,Jan Salas,ESP,MF,Mallorca,es  La Liga,19-213,2005.0,0.2,1,1,0,1,0,1,1,100.0,0,0,0,0,0,1,0,0
2215,Kike Salas,ESP,DF,Sevilla,es  La Liga,22-322,2002.0,15.4,27,18,11,10,6,16,27,59.3,11,17,8,9,22,49,82,0
2216,Manolis Saliakas,GRE,"MF,DF",St. Pauli,de  Bundesliga,28-180,1996.0,17.1,33,15,15,15,3,18,33,54.5,15,22,4,18,14,47,42,0
2217,William Saliba,FRA,DF,Arsenal,eng  Premier League,23-352,2001.0,25.3,48,29,28,18,2,16,21,76.2,5,16,9,7,19,67,81,3
2218,Mohammed Salisu,GHA,DF,Monaco,fr  Ligue 1,25-328,1999.0,11.3,28,18,16,11,1,13,15,86.7,2,10,8,2,16,44,54,2
2219,Roland Sallai,HUN,"FW,MF",Freiburg,de  Bundesliga,27-293,1997.0,0.5,2,1,1,1,0,0,0,,0,0,0,0,1,3,0,0
2220,Yoann Salmier,GUF,DF,Le Havre,fr  Ligue 1,32-110,1992.0,8.9,14,7,9,4,1,10,13,76.9,3,12,8,4,10,24,59,0
2221,Lazar Samardzic,SRB,"MF,FW",Atalanta,it  Serie A,23-015,2002.0,10.8,16,12,4,6,6,8,19,42.1,11,8,1,7,2,18,6,0
2222,Diadie Samassékou,MLI,MF,Hoffenheim,de  Bundesliga,29-059,1996.0,3.2,5,5,1,2,2,2,4,50.0,2,4,2,2,5,10,5,0
2223,Mama Samba Baldé,GNB,FW,Lyon,fr  Ligue 1,29-125,1995.0,0.4,2,2,0,2,0,0,0,,0,0,0,0,1,3,1,0
2224,Mama Samba Baldé,GNB,FW,Brest,fr  Ligue 1,29-125,1995.0,11.0,7,5,2,1,4,2,10,20.0,8,5,0,5,5,12,14,0
2225,Brice Samba,FRA,GK,Rennes,fr  Ligue 1,30-320,1994.0,8.0,1,0,1,0,0,1,1,100.0,0,0,0,0,0,1,9,2
2226,Brice Samba,FRA,GK,Lens,fr  Ligue 1,30-320,1994.0,15.0,0,0,0,0,0,0,0,,0,0,0,0,1,1,6,2
2227,Albert Sambi Lokonga,BEL,MF,Sevilla,es  La Liga,25-140,1999.0,12.6,18,13,9,8,1,8,11,72.7,3,8,1,7,7,25,18,3
2228,Junior Sambia,FRA,"DF,FW",Empoli,it  Serie A,28-185,1996.0,1.9,9,7,3,3,3,7,7,100.0,0,2,0,2,1,10,1,0
2229,Chuky san jose,ESP,"MF,FW",Valladolid,es  La Liga,20-316,2004.0,3.5,5,2,2,1,2,2,7,28.6,5,3,0,3,0,5,1,0
2230,Antonio Sanabria,PAR,FW,Torino,it  Serie A,29-007,1996.0,12.5,2,2,1,0,1,1,4,25.0,3,6,1,5,1,3,9,0
2231,Oihan Sancet,ESP,MF,Athletic Club,es  La Liga,24-320,2000.0,15.0,10,6,6,3,1,4,12,33.3,8,9,0,9,5,15,5,0
2232,Alexis Sánchez,CHI,FW,Udinese,it  Serie A,36-082,1988.0,3.4,3,1,0,2,1,1,5,20.0,4,3,0,3,2,5,0,1
2233,Antonio Sánchez,ESP,"MF,DF",Mallorca,es  La Liga,28-069,1997.0,10.3,19,12,13,4,2,11,23,47.8,12,11,2,9,13,32,26,0
2234,Iván Sánchez,ESP,"MF,FW",Valladolid,es  La Liga,32-169,1992.0,10.3,23,13,13,5,5,8,19,42.1,11,11,3,8,9,32,7,0
2235,Javi Sánchez,ESP,DF,Valladolid,es  La Liga,27-362,1997.0,18.4,22,14,16,5,1,15,24,62.5,9,30,22,8,18,40,94,3
2236,Juanlu Sánchez,ESP,"MF,DF",Sevilla,es  La Liga,21-208,2003.0,12.5,25,18,15,8,2,17,28,60.7,11,13,0,13,8,33,14,0
2237,Manu Sánchez,ESP,DF,Alavés,es  La Liga,24-199,2000.0,19.7,54,36,28,19,7,28,48,58.3,20,36,4,32,20,74,42,1
2238,Robert Sánchez,ESP,GK,Chelsea,eng  Premier League,27-113,1997.0,22.0,0,0,0,0,0,0,1,0.0,1,0,0,0,2,2,15,7
2239,Jadon Sancho,ENG,FW,Chelsea,eng  Premier League,24-351,2000.0,15.1,9,5,2,2,5,5,11,45.5,6,4,0,4,1,10,6,2
2240,Philipp Sander,GER,MF,Gladbach,de  Bundesliga,27-018,1998.0,12.9,28,14,13,13,2,9,18,50.0,9,13,5,8,19,47,38,3
2241,James Sands,USA,"MF,DF",St. Pauli,de  Bundesliga,24-248,2000.0,5.0,15,6,5,8,2,4,4,100.0,0,5,1,4,5,20,8,0
2242,Leroy Sané,GER,FW,Bayern Munich,de  Bundesliga,29-059,1996.0,12.3,17,11,2,7,8,8,14,57.1,6,7,0,7,6,23,1,0
2243,Arouna Sangante,SEN,DF,Le Havre,fr  Ligue 1,22-333,2002.0,8.8,14,10,7,7,0,6,10,60.0,4,9,5,4,16,30,34,1
2244,Ibrahim Sangaré,CIV,MF,Nott'ham Forest,eng  Premier League,27-099,1997.0,3.0,18,10,5,12,1,4,10,40.0,6,5,0,5,2,20,4,0
2245,Nhoa Sangui,FRA,"DF,MF",Reims,fr  Ligue 1,19-012,2006.0,10.5,14,7,5,5,4,7,10,70.0,3,7,3,4,5,19,18,0
2246,Maroan Sannadi,ESP,FW,Athletic Club,es  La Liga,24-038,2001.0,2.4,0,0,0,0,0,0,1,0.0,1,1,0,1,0,0,0,0
2247,Kaishu Sano,JPN,MF,Mainz 05,de  Bundesliga,24-071,2000.0,24.8,46,28,14,24,8,15,33,45.5,18,51,10,41,40,86,46,0
2248,Nicola Sansone,ITA,"MF,FW",Lecce,it  Serie A,33-182,1991.0,0.7,0,0,0,0,0,0,0,,0,0,0,0,0,0,0,0
2249,Baptiste Santamaria,FRA,MF,Nice,fr  Ligue 1,30-002,1995.0,6.7,17,8,9,6,2,12,17,70.6,5,10,2,8,14,31,15,1
2250,Baptiste Santamaria,FRA,MF,Rennes,fr  Ligue 1,30-002,1995.0,5.4,11,4,7,3,1,6,11,54.5,5,10,4,6,12,23,7,0
2251,Jesús Santiago,ESP,MF,Getafe,es  La Liga,20-290,2004.0,3.5,12,7,6,6,0,5,8,62.5,3,5,2,3,0,12,3,0
2252,Andrey Santos,BRA,MF,Strasbourg,fr  Ligue 1,20-312,2004.0,22.7,82,56,39,35,8,36,62,58.1,26,33,12,21,19,101,50,1
2253,Kauã Santos,BRA,GK,Eint Frankfurt,de  Bundesliga,21-334,2003.0,4.5,0,0,0,0,0,0,0,,0,0,0,0,0,0,2,2
2254,Tiago Santos,POR,DF,Lille,fr  Ligue 1,22-231,2002.0,4.5,12,7,4,5,3,6,9,66.7,3,2,0,2,2,14,4,0
2255,Pablo Sarabia,ESP,"MF,FW",Wolves,eng  Premier League,32-304,1992.0,6.0,12,7,4,7,1,7,11,63.6,4,6,0,6,4,16,5,1
2256,Jeremy Sarmiento,ECU,MF,Brighton,eng  Premier League,22-268,2002.0,0.1,0,0,0,0,0,0,0,,0,0,0,0,0,0,0,0
2257,Amin Sarr,SWE,FW,Hellas Verona,it  Serie A,24-000,2001.0,12.8,17,10,3,7,7,4,6,66.7,2,11,3,8,2,19,10,0
2258,Ismaila Sarr,SEN,"MF,FW",Crystal Palace,eng  Premier League,27-014,1998.0,21.4,16,8,6,7,3,5,19,26.3,14,18,6,12,6,22,28,0
2259,Malang Sarr,FRA,DF,Lens,fr  Ligue 1,26-047,1999.0,11.3,13,8,9,3,1,9,18,50.0,9,14,7,7,18,31,40,2
2260,Mamadou Sarr,FRA,DF,Strasbourg,fr  Ligue 1,19-194,2005.0,18.5,24,15,13,10,1,15,22,68.2,7,16,14,2,18,42,78,2
2261,Martin Satriano,URU,"FW,DF",Lens,fr  Ligue 1,24-019,2001.0,0.5,3,1,1,1,1,3,3,100.0,0,0,0,0,0,3,2,0
2262,Razvan Sava,ROU,GK,Udinese,it  Serie A,22-263,2002.0,12.0,0,0,0,0,0,0,0,,0,0,0,0,0,0,6,2
2263,Téji Savanier,FRA,MF,Montpellier,fr  Ligue 1,33-079,1991.0,21.9,26,21,6,15,5,17,39,43.6,22,14,1,13,12,38,17,4
2264,Sávio,BRA,"FW,MF",Manchester City,eng  Premier League,20-335,2004.0,16.7,18,12,4,9,5,5,14,35.7,9,11,2,9,4,22,7,1
2265,Nicolò Savona,ITA,DF,Juventus,it  Serie A,21-357,2003.0,15.6,26,13,17,8,1,12,23,52.2,11,7,1,6,7,33,22,0
2266,Saba Sazonov,GEO,DF,Torino,it  Serie A,23-038,2002.0,0.0,0,0,0,0,0,0,0,,0,1,1,0,0,0,0,0
2267,Joe Scally,USA,DF,Gladbach,de  Bundesliga,22-070,2002.0,21.3,36,26,20,14,2,22,39,56.4,17,29,11,18,13,49,61,1
2268,Giorgio Scalvini,ITA,DF,Atalanta,it  Serie A,21-090,2003.0,3.0,8,4,5,3,0,5,9,55.6,4,0,0,0,4,12,7,0
2269,Gianluca Scamacca,ITA,FW,Atalanta,it  Serie A,26-069,1999.0,0.1,0,0,0,0,0,0,0,,0,0,0,0,0,0,0,0
2270,Oliver Scarles,ENG,DF,West Ham,eng  Premier League,19-089,2005.0,4.5,14,10,10,3,1,10,14,71.4,4,11,2,9,8,22,14,0
2271,Dane Scarlett,ENG,FW,Tottenham,eng  Premier League,20-352,2004.0,0.3,1,0,0,1,0,0,0,,0,0,0,0,0,1,1,0
2272,Kevin Schade,GER,FW,Brentford,eng  Premier League,23-104,2001.0,16.6,28,19,10,8,10,11,18,61.1,7,10,2,8,4,32,25,0
2273,András Schäfer,HUN,MF,Union Berlin,de  Bundesliga,25-332,1999.0,10.1,30,14,12,15,3,15,25,60.0,10,24,3,21,14,44,18,0
2274,Fabian Schär,SUI,DF,Newcastle Utd,eng  Premier League,33-081,1991.0,22.8,25,16,12,13,0,9,23,39.1,14,31,19,12,33,58,91,2
2275,Patrik Schick,CZE,FW,Leverkusen,de  Bundesliga,29-046,1996.0,11.9,5,4,1,2,2,1,4,25.0,3,5,0,5,2,7,11,1
2276,Stefan Schimmer,GER,"FW,MF",Heidenheim,de  Bundesliga,30-317,1994.0,2.5,2,0,1,1,0,1,1,100.0,0,1,0,1,0,2,2,0
2277,Joël Schingtienne,BEL,DF,Venezia,it  Serie A,22-211,2002.0,5.7,12,7,9,3,0,5,9,55.6,4,10,4,6,5,17,11,1
2278,Xaver Schlager,AUT,MF,RB Leipzig,de  Bundesliga,27-164,1997.0,2.0,4,2,2,1,1,3,7,42.9,4,7,0,7,0,4,3,0
2279,Keven Schlotterbeck,GER,DF,Augsburg,de  Bundesliga,27-317,1997.0,13.1,17,15,8,9,0,10,14,71.4,4,11,5,6,13,30,66,1
2280,Nico Schlotterbeck,GER,DF,Dortmund,de  Bundesliga,25-100,1999.0,20.0,33,21,18,14,1,26,42,61.9,16,27,14,13,21,54,71,1
2281,Jeffrey Schlupp,GHA,"MF,DF",Crystal Palace,eng  Premier League,32-078,1992.0,1.1,2,0,1,0,1,0,3,0.0,3,6,0,6,0,2,2,0
2282,Romano Schmid,AUT,MF,Werder Bremen,de  Bundesliga,25-043,2000.0,22.7,36,21,9,19,8,19,42,45.2,23,34,2,32,11,47,7,2
2283,Niklas Schmidt,GER,MF,Toulouse,fr  Ligue 1,27-010,1998.0,2.3,6,4,1,5,0,4,7,57.1,3,0,0,0,1,7,4,0
2284,Jan Schöppner,GER,MF,Heidenheim,de  Bundesliga,25-272,1999.0,21.9,42,23,14,20,8,16,51,31.4,35,30,5,25,34,76,67,1
2285,Marvin Schulz,GER,"DF,MF",Holstein Kiel,de  Bundesliga,30-055,1995.0,3.0,5,4,2,2,1,2,8,25.0,6,10,6,4,0,5,13,0
2286,Alexander Schwolow,GER,GK,Union Berlin,de  Bundesliga,32-282,1992.0,5.0,0,0,0,0,0,0,0,,0,0,0,0,0,0,1,0
2287,Léo Scienza,BRA,"FW,MF",Heidenheim,de  Bundesliga,26-179,1998.0,10.9,13,9,8,4,1,5,14,35.7,9,11,1,10,5,18,8,1
2288,Alex Scott,ENG,MF,Bournemouth,eng  Premier League,21-202,2003.0,4.2,20,9,9,6,5,14,25,56.0,11,9,1,8,8,28,6,0
2289,Simone Scuffet,ITA,GK,Cagliari,it  Serie A,28-284,1996.0,13.0,0,0,0,0,0,0,1,0.0,1,0,0,0,0,0,8,2
2290,Jérémy Sebas,MTQ,"FW,MF",Strasbourg,fr  Ligue 1,21-331,2003.0,2.1,3,2,1,1,1,2,3,66.7,1,2,0,2,0,3,4,0
2291,Aleksandar Sedlar,SRB,DF,Alavés,es  La Liga,33-088,1991.0,4.7,15,9,5,10,0,7,9,77.8,2,2,1,1,7,22,12,1
2292,Jacopo Seghetti,ITA,GK,Empoli,it  Serie A,20-022,2005.0,1.0,0,0,0,0,0,0,0,,0,0,0,0,0,0,0,0
2293,Alidu Seidu,GHA,DF,Rennes,fr  Ligue 1,24-280,2000.0,8.9,22,18,14,6,2,12,15,80.0,3,13,6,7,14,36,17,0
2294,Nicolas Seiwald,AUT,"DF,MF",RB Leipzig,de  Bundesliga,23-311,2001.0,14.5,31,18,13,15,3,18,36,50.0,18,25,7,18,25,56,54,2
2295,Hiroki Sekine,JPN,DF,Reims,fr  Ligue 1,22-212,2002.0,3.5,3,1,2,1,0,2,4,50.0,2,6,1,5,4,7,13,0
2296,Matz Sels,BEL,GK,Nott'ham Forest,eng  Premier League,33-013,1992.0,28.0,1,1,1,0,0,1,1,100.0,0,0,0,0,0,1,17,1
2297,Nélson Semedo,POR,DF,Wolves,eng  Premier League,31-115,1993.0,22.8,47,27,27,14,6,25,42,59.5,17,26,10,16,11,58,83,2
2298,Antoine Semenyo,GHA,FW,Bournemouth,eng  Premier League,25-063,2000.0,26.4,42,24,14,21,7,12,37,32.4,25,52,7,45,6,48,26,0
2299,Marvin Senaya,TOG,DF,Strasbourg,fr  Ligue 1,24-042,2001.0,2.5,8,3,5,2,1,6,12,50.0,6,6,2,4,7,15,12,0
2300,Marcos Senesi,ARG,DF,Bournemouth,eng  Premier League,27-305,1997.0,10.2,33,21,21,10,2,13,26,50.0,13,14,6,8,11,44,42,0
2301,Stefano Sensi,ITA,MF,Monza,it  Serie A,29-218,1995.0,2.3,6,4,2,4,0,5,6,83.3,1,3,2,1,3,9,2,1
2302,Suat Serdar,GER,MF,Hellas Verona,it  Serie A,27-334,1997.0,10.4,20,13,7,13,0,4,17,23.5,13,12,3,9,6,26,13,0
2303,Sergi,ESP,DF,Leganés,es  La Liga,32-325,1992.0,24.9,33,25,19,13,1,15,25,60.0,10,27,20,7,32,65,144,2
2304,Nicolás Serrano,ESP,FW,Athletic Club,es  La Liga,22-006,2003.0,1.2,1,1,0,1,0,1,3,33.3,2,4,0,4,1,2,1,0
2305,Benjamin Šeško,SVN,"FW,MF",RB Leipzig,de  Bundesliga,21-284,2003.0,19.8,7,3,0,4,3,3,9,33.3,6,11,3,8,5,12,15,0
2306,Ryan Sessegnon,ENG,"DF,MF",Fulham,eng  Premier League,24-297,2000.0,1.0,4,0,2,2,0,2,5,40.0,3,0,0,0,1,5,2,0
2307,Stephan El Shaarawy,ITA,"DF,MF",Roma,it  Serie A,32-135,1992.0,10.4,13,11,3,5,5,5,10,50.0,5,3,0,3,8,21,10,0
2308,Luke Shaw,ENG,DF,Manchester Utd,eng  Premier League,29-242,1995.0,0.8,2,2,1,1,0,1,1,100.0,0,1,0,1,1,3,1,0
2309,Alen Sherri,ALB,GK,Cagliari,it  Serie A,27-086,1997.0,6.0,1,0,1,0,0,1,2,50.0,1,0,0,0,0,1,1,0
2310,Eldor Shomurodov,UZB,FW,Roma,it  Serie A,29-255,1995.0,6.0,9,2,2,4,3,2,4,50.0,2,7,0,7,0,9,2,0
2311,Djibril Sidibé,FRA,DF,Toulouse,fr  Ligue 1,32-225,1992.0,14.9,47,24,25,15,7,22,36,61.1,14,8,2,6,16,63,42,0
2312,Armindo Sieb,GER,"FW,MF",Mainz 05,de  Bundesliga,22-022,2003.0,8.0,9,3,3,5,1,3,10,30.0,7,4,0,4,1,10,7,0
2313,Vincent Sierro,SUI,MF,Toulouse,fr  Ligue 1,29-154,1995.0,17.7,37,21,13,20,4,23,40,57.5,17,24,4,20,12,49,31,1
2314,Tim Siersleben,GER,DF,Heidenheim,de  Bundesliga,25-002,2000.0,6.3,11,7,7,3,1,6,11,54.5,5,9,4,5,10,21,40,0
2315,Zain Silcott-Duberry,MSR,FW,Bournemouth,eng  Premier League,19-245,2005.0,0.0,1,1,0,0,1,1,1,100.0,0,0,0,0,0,1,0,0
2316,Kiliann Sildillia,FRA,DF,Freiburg,de  Bundesliga,22-299,2002.0,6.9,13,7,7,4,2,6,11,54.5,5,13,5,8,8,21,25,0
2317,André Silva,POR,FW,Werder Bremen,de  Bundesliga,29-125,1995.0,3.4,2,2,1,1,0,0,1,0.0,1,3,1,2,0,2,3,0
2318,André Silva,POR,"FW,MF",RB Leipzig,de  Bundesliga,29-125,1995.0,1.5,1,1,1,0,0,0,1,0.0,1,1,0,1,1,2,2,0
2319,Bernardo Silva,POR,"MF,FW",Manchester City,eng  Premier League,30-213,1994.0,22.5,39,26,12,21,6,21,45,46.7,24,23,5,18,17,56,19,3
2320,Caio Henrique Oliveira Silva,BRA,DF,Monaco,fr  Ligue 1,27-223,1997.0,12.9,25,19,12,11,2,14,29,48.3,15,15,2,13,10,35,32,0
2321,Fábio Silva,POR,FW,Las Palmas,es  La Liga,22-235,2002.0,15.9,9,5,4,3,2,3,11,27.3,8,11,0,11,3,12,22,0
2322,Jota Silva,POR,"FW,MF",Nott'ham Forest,eng  Premier League,25-222,1999.0,7.9,22,11,11,9,2,4,24,16.7,20,9,1,8,12,34,15,0
2323,Eric da Silva Moreira,GER,"MF,DF",Nott'ham Forest,eng  Premier League,18-312,2006.0,0.3,2,2,2,0,0,2,6,33.3,4,0,0,0,1,3,0,0
2324,Rui Silva,POR,GK,Betis,es  La Liga,31-032,1994.0,15.0,0,0,0,0,0,0,1,0.0,1,1,0,1,0,0,7,0
2325,Marco Silvestri,ITA,GK,Empoli,it  Serie A,34-009,1991.0,4.0,0,0,0,0,0,0,2,0.0,2,0,0,0,0,0,3,1
2326,Abdallah Sima,SEN,"FW,MF",Brest,fr  Ligue 1,23-267,2001.0,10.0,9,8,1,3,5,4,9,44.4,5,5,0,5,1,10,9,0
2327,Mohamed Simakan,FRA,DF,RB Leipzig,de  Bundesliga,24-312,2000.0,0.6,0,0,0,0,0,0,0,,0,0,0,0,2,2,0,0
2328,Giovanni Simeone,ARG,FW,Napoli,it  Serie A,29-249,1995.0,4.0,2,0,0,1,1,1,6,16.7,5,8,1,7,1,3,5,0
2329,Giuliano Simeone,ARG,"MF,DF",Atlético Madrid,es  La Liga,22-083,2002.0,13.4,18,8,4,7,7,10,18,55.6,8,15,1,14,9,27,12,0
2330,Moses Simon,NGA,"FW,MF",Nantes,fr  Ligue 1,29-242,1995.0,20.3,13,9,2,5,6,6,17,35.3,11,10,0,10,9,22,12,0
2331,Unai Simón,ESP,GK,Athletic Club,es  La Liga,27-273,1997.0,10.0,0,0,0,0,0,0,0,,0,0,0,0,0,0,6,3
2332,Xavi Simons,NED,MF,RB Leipzig,de  Bundesliga,21-324,2003.0,16.2,17,12,4,11,2,9,15,60.0,6,9,2,7,8,25,12,0
2333,Jahmai Simpson-Pusey,ENG,DF,Manchester City,eng  Premier League,19-127,2005.0,1.1,1,0,1,0,0,0,1,0.0,1,1,1,0,0,1,2,0
2334,Danel Sinani,LUX,"FW,MF",St. Pauli,de  Bundesliga,27-340,1997.0,5.7,9,7,1,4,4,3,8,37.5,5,7,1,6,1,10,7,0
2335,Lassine Sinayoko,MLI,"FW,MF",Auxerre,fr  Ligue 1,25-093,1999.0,18.0,25,15,7,11,7,10,19,52.6,9,12,1,11,9,34,27,0
2336,Wilfried Singo,CIV,DF,Monaco,fr  Ligue 1,24-076,2000.0,14.3,25,17,17,7,1,12,18,66.7,6,7,3,4,31,56,61,2
2337,Luis Sinisterra,COL,"FW,MF",Bournemouth,eng  Premier League,25-267,1999.0,2.4,7,2,3,2,2,0,4,0.0,4,3,0,3,1,8,6,0
2338,Daley Sinkgraven,NED,DF,Las Palmas,es  La Liga,29-250,1995.0,1.0,5,1,3,2,0,1,3,33.3,2,1,0,1,1,6,2,0
2339,Tobias Sippel,GER,GK,Gladbach,de  Bundesliga,36-354,1988.0,0.7,0,0,0,0,0,0,0,,0,0,0,0,0,0,0,0
2340,Jailson Siqueira,BRA,"DF,MF",Celta Vigo,es  La Liga,29-185,1995.0,6.0,11,9,7,3,1,8,10,80.0,2,6,4,2,9,20,24,1
2341,Ayanda Sishuba,BEL,FW,Rennes,fr  Ligue 1,20-037,2005.0,0.0,1,0,1,0,0,1,1,100.0,0,0,0,0,0,1,0,0
2342,Ibrahim Sissoko,MLI,FW,Saint-Étienne,fr  Ligue 1,29-104,1995.0,9.0,11,9,5,3,3,2,5,40.0,3,10,2,8,2,13,13,0
2343,Ibrahima Sissoko,MLI,MF,Bochum,de  Bundesliga,27-135,1997.0,21.8,52,36,26,22,4,22,40,55.0,18,25,5,20,31,83,47,0
2344,Niama Sissoko,MLI,"FW,MF",Reims,fr  Ligue 1,19-085,2005.0,0.5,0,0,0,0,0,0,0,,0,1,0,1,0,0,0,0
2345,Antonio Sivera,ESP,GK,Alavés,es  La Liga,28-212,1996.0,22.2,1,0,1,0,0,1,1,100.0,0,0,0,0,0,1,13,0
2346,Tim Skarke,GER,"FW,MF",Union Berlin,de  Bundesliga,28-185,1996.0,9.8,10,9,4,6,0,7,15,46.7,8,6,0,6,5,15,10,0
2347,Ellyes Skhiri,TUN,MF,Eint Frankfurt,de  Bundesliga,29-305,1995.0,17.1,21,12,8,11,2,9,30,30.0,21,23,5,18,22,43,31,3
2348,Oliver Skipp,ENG,MF,Leicester City,eng  Premier League,24-176,2000.0,8.7,14,4,4,9,1,6,9,66.7,3,14,3,11,8,22,10,1
2349,Leo Skiri Østigård,NOR,DF,Rennes,fr  Ligue 1,25-103,1999.0,13.6,20,18,16,4,0,15,22,68.2,7,12,10,2,15,35,81,1
2350,Leo Skiri Østigård,NOR,DF,Hoffenheim,de  Bundesliga,25-103,1999.0,4.0,2,2,1,1,0,0,1,0.0,1,9,5,4,3,5,46,0
2351,Łukasz Skorupski,POL,GK,Bologna,it  Serie A,33-310,1991.0,20.0,1,0,1,0,0,1,2,50.0,1,0,0,0,0,1,7,1
2352,Andreas Skov Olsen,DEN,"FW,MF",Wolfsburg,de  Bundesliga,25-072,1999.0,3.0,4,3,3,1,0,2,2,100.0,0,2,0,2,1,5,6,0
2353,Robert Skov,DEN,"DF,MF",Union Berlin,de  Bundesliga,28-295,1996.0,9.5,15,11,8,7,0,10,20,50.0,10,8,1,7,8,23,9,0
2354,Milan Škriniar,SVK,DF,Paris S-G,fr  Ligue 1,30-028,1995.0,4.2,7,5,3,4,0,3,3,100.0,0,7,6,1,3,10,16,0
2355,Steven Skrzybski,GER,"FW,MF",Holstein Kiel,de  Bundesliga,32-113,1992.0,7.9,10,1,1,5,4,5,12,41.7,7,10,0,10,8,18,4,0
2356,Naatan Skyttä,FIN,FW,Toulouse,fr  Ligue 1,22-308,2002.0,0.1,1,0,0,0,1,0,0,,0,0,0,0,0,1,0,0
2357,William Smallbone,IRL,MF,Southampton,eng  Premier League,25-018,2000.0,6.2,14,7,7,5,2,6,18,33.3,12,7,0,7,2,16,12,2
2358,Adam Smith,ENG,DF,Bournemouth,eng  Premier League,33-316,1991.0,11.5,16,8,8,4,4,9,19,47.4,10,9,2,7,11,27,37,1
2359,Eric Smith,SWE,"DF,MF",St. Pauli,de  Bundesliga,28-062,1997.0,22.4,32,23,19,10,3,16,26,61.5,10,29,9,20,28,60,83,3
2360,Justin Smith,CAN,MF,Espanyol,es  La Liga,22-035,2003.0,2.3,9,3,3,6,0,4,6,66.7,2,5,1,4,4,13,3,0
2361,Emile Smith Rowe,ENG,MF,Fulham,eng  Premier League,24-226,2000.0,18.4,26,14,6,11,9,7,21,33.3,14,17,1,16,8,34,11,0
2362,Ivan Smolčić,CRO,DF,Como,it  Serie A,24-206,2000.0,4.6,12,6,6,5,1,7,9,77.8,2,6,1,5,9,21,19,0
2363,Eduard Sobol,UKR,DF,Strasbourg,fr  Ligue 1,29-325,1995.0,0.9,0,0,0,0,0,0,2,0.0,2,2,1,1,2,2,12,0
2364,Simon Sohm,SUI,MF,Parma,it  Serie A,23-334,2001.0,25.5,22,14,8,10,4,12,27,44.4,15,6,1,5,20,42,30,0
2365,Alex Sola,ESP,"MF,FW",Getafe,es  La Liga,25-275,1999.0,11.4,21,14,9,12,0,9,25,36.0,16,8,0,8,7,28,11,1
2366,Dominic Solanke,ENG,FW,Tottenham,eng  Premier League,27-178,1997.0,18.8,15,9,1,10,4,3,9,33.3,6,13,4,9,0,15,19,0
2367,Ola Solbakken,NOR,"MF,FW",Empoli,it  Serie A,26-185,1998.0,6.6,5,3,0,5,0,2,4,50.0,2,0,0,0,2,7,8,0
2368,Carlos Soler,ESP,"MF,FW",West Ham,eng  Premier League,28-068,1997.0,12.1,12,10,7,5,0,5,20,25.0,15,14,3,11,5,17,14,2
2369,Oumar Solet,FRA,DF,Udinese,it  Serie A,25-032,2000.0,8.6,17,12,13,4,0,6,12,50.0,6,18,10,8,10,27,33,0
2370,Jhon Solis,COL,MF,Girona,es  La Liga,20-159,2004.0,4.6,8,4,2,5,1,4,11,36.4,7,12,1,11,4,12,6,1
2371,Yann Sommer,SUI,GK,Inter,it  Serie A,36-084,1988.0,25.0,0,0,0,0,0,0,0,,0,0,0,0,0,0,6,1
2372,David Soria,ESP,GK,Getafe,es  La Liga,31-341,1993.0,27.0,4,4,4,0,0,4,5,80.0,1,0,0,0,1,5,14,2
2373,Juan Soriano,ESP,GK,Leganés,es  La Liga,27-200,1997.0,6.0,1,1,1,0,0,1,1,100.0,0,0,0,0,0,1,2,0
2374,Borna Sosa,CRO,DF,Torino,it  Serie A,27-049,1998.0,13.1,26,19,14,7,5,16,25,64.0,9,13,6,7,14,40,33,0
2375,Ramón Sosa,PAR,"FW,MF",Nott'ham Forest,eng  Premier League,25-192,1999.0,2.7,4,2,2,0,2,1,3,33.3,2,7,0,7,3,7,4,0
2376,Hugo Sotelo,ESP,MF,Celta Vigo,es  La Liga,21-082,2003.0,11.6,25,15,8,9,8,11,24,45.8,13,8,1,7,4,29,7,1
2377,Florian Sotoca,FRA,"FW,MF",Lens,fr  Ligue 1,34-137,1990.0,15.6,16,10,2,3,11,9,18,50.0,9,10,1,9,9,25,23,0
2378,Riccardo Sottil,ITA,"FW,MF",Fiorentina,it  Serie A,25-281,1999.0,9.3,5,4,3,1,1,3,4,75.0,1,1,0,1,4,9,3,0
2379,Riccardo Sottil,ITA,"FW,MF",Milan,it  Serie A,25-281,1999.0,0.9,0,0,0,0,0,0,0,,0,0,0,0,0,0,0,0
2380,Tomáš Souček,CZE,MF,West Ham,eng  Premier League,30-012,1995.0,22.1,32,16,12,17,3,16,32,50.0,16,31,14,17,13,45,65,1
2381,Matìas Soulé,ARG,"MF,FW",Roma,it  Serie A,21-330,2003.0,10.7,12,7,4,3,5,5,11,45.5,6,15,1,14,4,16,9,0
2382,Boubakary Soumaré,FRA,MF,Leicester City,eng  Premier League,26-012,1999.0,16.7,29,14,19,9,1,16,26,61.5,10,12,4,8,21,50,20,2
2383,Issa Soumaré,SEN,"MF,FW",Le Havre,fr  Ligue 1,24-152,2000.0,13.4,15,9,4,8,3,8,26,30.8,18,10,4,6,7,22,19,0
2384,Djibril Sow,SUI,MF,Sevilla,es  La Liga,28-033,1997.0,16.6,16,8,8,7,1,4,10,40.0,6,11,2,9,16,32,17,0
2385,Saidou Sow,GUI,DF,Strasbourg,fr  Ligue 1,22-250,2002.0,11.3,9,5,6,3,0,6,12,50.0,6,15,9,6,15,24,37,2
2386,Saidou Sow,GUI,DF,Nantes,fr  Ligue 1,22-250,2002.0,6.0,13,9,9,4,0,5,8,62.5,3,10,7,3,8,21,29,1
2387,Djed Spence,ENG,DF,Tottenham,eng  Premier League,24-214,2000.0,10.8,30,25,19,6,5,18,22,81.8,4,18,7,11,12,42,34,1
2388,Leonardo Spinazzola,ITA,"DF,FW",Napoli,it  Serie A,31-351,1993.0,10.0,10,8,5,4,1,6,15,40.0,9,6,1,5,4,14,20,1
2389,Marco Sportiello,ITA,GK,Milan,it  Serie A,32-305,1992.0,1.0,0,0,0,0,0,0,0,,0,0,0,0,0,0,1,0
2390,Anton Stach,GER,"MF,DF",Hoffenheim,de  Bundesliga,26-116,1998.0,19.8,48,35,19,25,4,24,34,70.6,10,32,8,24,28,76,69,1
2391,Jens Stage,DEN,MF,Werder Bremen,de  Bundesliga,28-123,1996.0,16.2,31,20,14,15,2,17,32,53.1,15,30,6,24,17,48,31,1
2392,Josip Stanišić,CRO,DF,Bayern Munich,de  Bundesliga,24-343,2000.0,2.0,5,5,2,1,2,3,4,75.0,1,3,1,2,2,7,10,1
2393,Filip Stankovic,SRB,GK,Venezia,it  Serie A,23-014,2002.0,15.2,0,0,0,0,0,0,0,,0,0,0,0,0,0,11,2
2394,Jay Stansfield,ENG,MF,Fulham,eng  Premier League,22-107,2002.0,0.0,0,0,0,0,0,0,0,,0,0,0,0,0,0,0,0
2395,Carl Starfelt,SWE,DF,Celta Vigo,es  La Liga,29-283,1995.0,22.1,32,14,21,10,1,14,21,66.7,7,28,20,8,29,61,116,3
2396,Niklas Stark,GER,DF,Werder Bremen,de  Bundesliga,29-331,1995.0,15.4,24,15,14,8,2,11,17,64.7,6,30,21,9,22,46,76,1
2397,Lucas Stassin,BEL,FW,Saint-Étienne,fr  Ligue 1,20-103,2004.0,15.3,12,9,2,4,6,5,13,38.5,8,9,0,9,2,14,7,0
2398,Jason Steele,ENG,GK,Brighton,eng  Premier League,34-205,1990.0,2.0,0,0,0,0,0,0,0,,0,0,0,0,0,0,1,0
2399,Orri Steinn Óskarsson,ISL,FW,Real Sociedad,es  La Liga,20-194,2004.0,8.8,6,6,2,1,3,2,8,25.0,6,10,1,9,2,8,8,0
2400,Pascal Stenzel,GER,DF,Stuttgart,de  Bundesliga,28-356,1996.0,1.5,1,0,1,0,0,0,1,0.0,1,4,1,3,0,1,4,0
2401,Jack Stephens,ENG,DF,Southampton,eng  Premier League,31-043,1994.0,8.9,15,10,12,3,0,6,16,37.5,10,8,6,2,5,20,33,2
2402,Leonidas Stergiou,SUI,DF,Stuttgart,de  Bundesliga,23-008,2002.0,5.9,21,12,7,11,3,14,16,87.5,2,11,4,7,7,28,18,0
2403,Raheem Sterling,ENG,"FW,MF",Arsenal,eng  Premier League,30-093,1994.0,3.4,6,4,0,2,4,3,5,60.0,2,2,0,2,1,7,2,0
2404,Enzo Sternal,FRA,"FW,MF",Marseille,fr  Ligue 1,17-287,2007.0,0.3,0,0,0,0,0,0,0,,0,0,0,0,0,0,0,0
2405,Finley Stevens,WAL,DF,St. Pauli,de  Bundesliga,21-335,2003.0,0.0,0,0,0,0,0,0,0,,0,0,0,0,0,0,0,0
2406,Ross Stewart,SCO,"FW,MF",Southampton,eng  Premier League,28-243,1996.0,1.5,0,0,0,0,0,0,3,0.0,3,3,0,3,0,0,4,0
2407,Angelo Stiller,GER,MF,Stuttgart,de  Bundesliga,23-341,2001.0,24.3,41,22,14,21,6,13,26,50.0,13,22,7,15,22,63,45,4
2408,Kevin Stöger,AUT,"MF,FW",Gladbach,de  Bundesliga,31-196,1993.0,14.3,32,17,19,9,4,14,32,43.8,18,19,1,18,11,43,21,2
2409,Stoichkov,ESP,"MF,FW",Alavés,es  La Liga,31-126,1993.0,7.8,14,9,6,7,1,6,11,54.5,5,2,0,2,1,15,7,0
2410,Petar Stojanović,SVN,MF,Empoli,it  Serie A,29-155,1995.0,0.0,0,0,0,0,0,0,0,,0,0,0,0,0,0,0,0
2411,Jakub Stolarczyk,POL,GK,Leicester City,eng  Premier League,24-082,2000.0,6.0,2,1,2,0,0,1,2,50.0,1,0,0,0,0,2,5,0
2412,John Stones,ENG,"DF,MF",Manchester City,eng  Premier League,30-287,1994.0,6.1,6,2,3,2,1,5,5,100.0,0,5,3,2,4,10,19,1
2413,Jørgen Strand Larsen,NOR,FW,Wolves,eng  Premier League,25-033,2000.0,22.0,8,5,2,3,3,4,22,18.2,18,16,3,13,4,12,21,0
2414,Gabriel Strefezza,BRA,"FW,MF",Como,it  Serie A,27-327,1997.0,22.6,47,35,19,15,13,19,46,41.3,27,21,2,19,9,56,22,0
2415,Cristhian Stuani,URU,FW,Girona,es  La Liga,38-150,1986.0,5.9,4,4,1,3,0,1,2,50.0,1,3,0,3,4,8,5,0
2416,Álex Suárez,ESP,DF,Las Palmas,es  La Liga,31-358,1993.0,21.2,33,17,25,7,1,15,22,68.2,7,32,21,11,7,40,84,1
2417,Denis Suárez,ESP,MF,Villarreal,es  La Liga,31-064,1994.0,4.0,5,4,4,0,1,2,5,40.0,3,2,1,1,1,6,1,0
2418,Gabriel Suazo,CHI,DF,Toulouse,fr  Ligue 1,27-214,1997.0,18.1,48,31,20,17,11,24,53,45.3,29,24,3,21,27,75,33,1
2419,Luka Sučić,CRO,MF,Real Sociedad,es  La Liga,22-184,2002.0,15.7,21,15,6,11,4,9,20,45.0,11,21,2,19,12,33,12,1
2420,Yukinari Sugawara,JPN,DF,Southampton,eng  Premier League,24-256,2000.0,15.2,27,15,13,13,1,16,27,59.3,11,17,7,10,10,37,45,3
2421,Niklas Süle,GER,DF,Dortmund,de  Bundesliga,29-189,1995.0,6.1,7,6,5,2,0,6,8,75.0,2,4,3,1,1,8,29,1
2422,Ibrahim Sulemana,GHA,MF,Atalanta,it  Serie A,21-293,2003.0,1.4,5,2,2,3,0,1,3,33.3,2,1,0,1,0,5,1,0
2423,Kamaldeen Sulemana,GHA,"FW,MF",Southampton,eng  Premier League,23-024,2002.0,7.3,12,10,4,3,5,6,9,66.7,3,6,0,6,3,15,3,0
2424,Crysencio Summerville,NED,"FW,MF",West Ham,eng  Premier League,23-132,2001.0,8.7,13,7,2,8,3,3,9,33.3,6,13,4,9,0,13,7,0
2425,Tomáš Suslov,SVK,"MF,FW",Hellas Verona,it  Serie A,22-277,2002.0,19.6,46,32,20,19,7,20,62,32.3,42,25,2,23,16,62,11,1
2426,Suso,ESP,"FW,MF",Sevilla,es  La Liga,31-112,1993.0,2.0,2,1,1,1,0,1,5,20.0,4,0,0,0,0,2,0,0
2427,Zion Suzuki,JPN,GK,Parma,it  Serie A,22-202,2002.0,26.8,1,0,1,0,0,1,1,100.0,0,0,0,0,0,1,21,4
2428,Mattias Svanberg,SWE,MF,Wolfsburg,de  Bundesliga,26-065,1999.0,12.4,19,10,5,11,3,9,16,56.3,7,11,4,7,12,31,26,0
2429,Daniel Svensson,SWE,DF,Dortmund,de  Bundesliga,23-027,2002.0,1.5,3,2,1,1,1,1,1,100.0,0,3,1,2,1,4,5,0
2430,Marin Šverko,CRO,DF,Venezia,it  Serie A,27-035,1998.0,11.6,17,6,11,6,0,8,10,80.0,2,9,4,5,16,33,42,3
2431,Mile Svilar,SRB,GK,Roma,it  Serie A,25-196,1999.0,28.0,0,0,0,0,0,0,0,,0,0,0,0,0,0,6,2
2432,Michael Svoboda,AUT,DF,Venezia,it  Serie A,26-147,1998.0,14.6,26,14,19,6,1,8,19,42.1,11,19,11,8,22,48,66,2
2433,Williot Swedberg,SWE,"FW,MF",Celta Vigo,es  La Liga,21-038,2004.0,11.7,16,12,5,7,4,10,13,76.9,3,10,1,9,3,19,8,1
2434,Abakar Sylla,CIV,DF,Strasbourg,fr  Ligue 1,22-076,2002.0,9.2,25,13,13,10,2,14,16,87.5,2,16,8,8,10,35,47,0
2435,Issiaga Sylla,GUI,DF,Montpellier,fr  Ligue 1,31-069,1994.0,10.1,22,7,15,6,1,12,24,50.0,12,12,4,8,9,31,29,1
2436,Mamadou Sylla,SEN,"FW,MF",Valladolid,es  La Liga,30-356,1994.0,11.8,3,1,0,1,2,1,3,33.3,2,5,0,5,1,4,10,1
2437,Wojciech Szczęsny,POL,GK,Barcelona,es  La Liga,34-327,1990.0,6.0,1,1,1,0,0,0,0,,0,0,0,0,0,1,5,0
2438,Sammie Szmodics,IRL,"FW,MF",Ipswich Town,eng  Premier League,29-168,1995.0,10.9,15,9,4,9,2,6,23,26.1,17,10,2,8,6,21,14,0
2439,Dominik Szoboszlai,HUN,MF,Liverpool,eng  Premier League,24-137,2000.0,21.7,29,19,8,16,5,15,37,40.5,22,33,4,29,9,38,13,1
2440,Alexander Sørloth,NOR,FW,Atlético Madrid,es  La Liga,29-096,1995.0,11.1,5,1,0,3,2,2,3,66.7,1,4,1,3,1,6,20,0
2441,Musa Al-Taamari,JOR,"FW,MF",Montpellier,fr  Ligue 1,27-274,1997.0,12.4,14,10,4,5,5,8,15,53.3,7,2,0,2,3,17,3,2
2442,Musa Al-Taamari,JOR,"MF,FW",Rennes,fr  Ligue 1,27-274,1997.0,3.1,2,0,1,0,1,0,1,0.0,1,3,0,3,1,3,0,0
2443,Haris Tabakovic,BIH,"FW,MF",Hoffenheim,de  Bundesliga,30-264,1994.0,5.3,1,1,0,0,1,0,2,0.0,2,3,2,1,1,2,9,0
2444,Nicolás Tagliafico,ARG,DF,Lyon,fr  Ligue 1,32-192,1992.0,15.1,47,33,21,16,10,24,37,64.9,13,20,6,14,29,76,42,0
2445,Jonathan Tah,GER,DF,Leverkusen,de  Bundesliga,29-028,1996.0,24.0,9,7,6,2,1,5,8,62.5,3,19,13,6,26,35,96,2
2446,Adrien Tameze,CMR,"MF,DF",Torino,it  Serie A,31-035,1994.0,6.6,5,2,2,3,0,1,9,11.1,8,8,5,3,10,15,7,1
2447,Renato Tapia,PER,"MF,DF",Leganés,es  La Liga,29-226,1995.0,16.3,36,20,13,20,3,10,26,38.5,16,39,16,23,15,51,59,0
2448,Edmond Tapsoba,BFA,DF,Leverkusen,de  Bundesliga,26-037,1999.0,22.4,34,20,15,15,4,18,33,54.5,15,14,9,5,23,57,66,0
2449,Florian Tardieu,FRA,MF,Saint-Étienne,fr  Ligue 1,32-323,1992.0,6.3,11,7,4,6,1,3,7,42.9,4,9,1,8,7,18,7,0
2450,Mehdi Taremi,IRN,FW,Inter,it  Serie A,32-236,1992.0,6.2,3,1,0,1,2,0,2,0.0,2,8,1,7,0,3,10,0
2451,Matt Targett,ENG,DF,Newcastle Utd,eng  Premier League,29-174,1995.0,0.1,0,0,0,0,0,0,1,0.0,1,0,0,0,1,1,1,0
2452,Oussama Targhalline,MAR,MF,Le Havre,fr  Ligue 1,22-295,2002.0,11.0,19,14,12,3,4,5,12,41.7,7,14,7,7,19,38,14,2
2453,James Tarkowski,ENG,DF,Everton,eng  Premier League,32-112,1992.0,27.9,57,35,35,19,3,22,37,59.5,15,49,36,13,34,91,183,4
2454,César Tárrega,ESP,DF,Valencia,es  La Liga,23-013,2002.0,23.6,32,23,21,9,2,15,23,65.2,8,25,13,12,17,49,132,1
2455,Nuno Tavares,POR,DF,Lazio,it  Serie A,25-044,2000.0,16.9,28,21,15,8,5,14,32,43.8,18,17,2,15,19,47,38,1
2456,Marcus Tavernier,ENG,"FW,MF",Bournemouth,eng  Premier League,25-354,1999.0,15.7,38,23,12,17,9,9,25,36.0,16,11,2,9,4,42,10,0
2457,Charlie Taylor,ENG,DF,Southampton,eng  Premier League,31-174,1993.0,3.0,7,5,4,3,0,5,6,83.3,1,5,3,2,3,10,22,1
2458,Jack Taylor,IRL,MF,Ipswich Town,eng  Premier League,26-261,1998.0,5.4,11,4,3,7,1,6,14,42.9,8,4,1,3,4,15,13,0
2459,Loum Tchaouna,FRA,"FW,MF",Lazio,it  Serie A,21-184,2003.0,6.3,8,4,2,2,4,3,9,33.3,6,5,1,4,3,11,8,2
2460,Jackson Tchatchoua,CMR,"DF,MF",Hellas Verona,it  Serie A,23-178,2001.0,25.2,42,27,29,10,3,25,36,69.4,11,17,8,9,10,52,58,2
2461,Enzo Tchato,CMR,DF,Montpellier,fr  Ligue 1,22-108,2002.0,19.6,45,23,25,16,4,25,42,59.5,17,29,9,20,22,67,53,0
2462,Aurélien Tchouaméni,FRA,"MF,DF",Real Madrid,es  La Liga,25-043,2000.0,21.2,32,15,13,17,2,13,29,44.8,16,21,15,6,34,66,49,1
2463,Álvaro Tejero,ESP,"MF,DF",Espanyol,es  La Liga,28-234,1996.0,12.8,12,4,5,6,1,5,19,26.3,14,9,1,8,11,23,31,1
2464,Martín Tejón,ESP,"MF,DF",Valencia,es  La Liga,20-333,2004.0,0.5,2,0,0,2,0,1,2,50.0,1,0,0,0,0,2,0,0
2465,Mathys Tel,FRA,FW,Tottenham,eng  Premier League,19-318,2005.0,2.5,0,0,0,0,0,0,2,0.0,2,2,0,2,0,0,1,1
2466,Mathys Tel,FRA,"FW,MF",Bayern Munich,de  Bundesliga,19-318,2005.0,2.8,2,2,0,2,0,0,0,,0,0,0,0,1,3,1,0
2467,Nathan Tella,NGA,"MF,FW",Leverkusen,de  Bundesliga,25-249,1999.0,10.9,10,5,1,5,4,2,8,25.0,6,10,0,10,4,14,3,0
2468,Nahuel Tenaglia,ARG,DF,Alavés,es  La Liga,29-018,1996.0,23.3,74,44,48,21,5,41,64,64.1,23,22,4,18,31,105,91,0
2469,Casper Tengstedt,DEN,"FW,MF",Hellas Verona,it  Serie A,24-283,2000.0,15.0,7,5,0,5,2,4,7,57.1,3,5,1,4,3,10,27,0
2470,Marc-André ter Stegen,GER,GK,Barcelona,es  La Liga,32-315,1992.0,5.5,0,0,0,0,0,0,1,0.0,1,0,0,0,0,0,2,2
2471,Filippo Terracciano,ITA,"DF,MF",Milan,it  Serie A,22-031,2003.0,5.9,8,5,1,5,2,4,8,50.0,4,1,0,1,6,14,11,0
2472,Pietro Terracciano,ITA,GK,Fiorentina,it  Serie A,35-003,1990.0,3.0,0,0,0,0,0,0,0,,0,0,0,0,0,0,0,0
2473,Ramón Terrats,ESP,"MF,FW",Villarreal,es  La Liga,24-144,2000.0,1.5,3,3,1,2,0,2,4,50.0,2,3,1,2,2,5,3,0
2474,Ramón Terrats,ESP,MF,Getafe,es  La Liga,24-144,2000.0,4.7,6,3,3,0,3,2,11,18.2,9,4,1,3,1,7,9,0
2475,Martin Terrier,FRA,"MF,FW",Leverkusen,de  Bundesliga,28-007,1997.0,6.5,4,2,1,0,3,1,4,25.0,3,3,0,3,1,5,1,0
2476,Tanner Tessmann,USA,MF,Lyon,fr  Ligue 1,23-168,2001.0,8.1,16,9,5,7,4,8,15,53.3,7,6,4,2,10,26,20,0
2477,Kenny Tete,NED,DF,Fulham,eng  Premier League,29-153,1995.0,14.0,41,27,20,12,9,17,28,60.7,11,19,6,13,28,69,36,0
2478,Teddy Teuma,MLT,MF,Reims,fr  Ligue 1,31-162,1993.0,8.3,18,10,6,6,6,7,25,28.0,18,12,2,10,12,30,8,1
2479,Jordan Teze,NED,DF,Monaco,fr  Ligue 1,25-162,1999.0,4.2,15,7,6,8,1,4,11,36.4,7,11,1,10,3,18,8,0
2480,Florian Thauvin,FRA,"FW,MF",Udinese,it  Serie A,32-044,1993.0,21.7,20,14,9,8,3,10,25,40.0,15,6,0,6,7,27,10,0
2481,Arthur Theate,BEL,DF,Eint Frankfurt,de  Bundesliga,24-290,2000.0,22.6,29,20,15,13,1,16,33,48.5,17,34,17,17,32,61,121,3
2482,Norman Theuerkauf,GER,MF,Heidenheim,de  Bundesliga,38-046,1987.0,0.2,0,0,0,0,0,0,0,,0,0,0,0,0,0,0,0
2483,Thiago,BRA,FW,Brentford,eng  Premier League,23-258,2001.0,1.5,2,2,1,0,1,0,1,0.0,1,0,0,0,2,4,2,1
2484,Malick Thiaw,GER,DF,Milan,it  Serie A,23-215,2001.0,17.2,19,13,12,5,2,5,8,62.5,3,12,10,2,14,33,70,0
2485,Denis Thomalla,GER,MF,Heidenheim,de  Bundesliga,32-207,1992.0,0.0,0,0,0,0,0,0,0,,0,0,0,0,0,0,0,0
2486,Luke Thomas,ENG,DF,Leicester City,eng  Premier League,23-274,2001.0,3.0,10,8,9,0,1,8,11,72.7,3,6,3,3,3,13,11,1
2487,Sorba Thomas,WAL,"FW,MF",Nantes,fr  Ligue 1,25-201,1999.0,10.4,8,4,3,4,1,5,11,45.5,6,8,0,8,2,10,16,1
2488,Adrien Thomasson,FRA,MF,Lens,fr  Ligue 1,31-091,1993.0,21.6,67,37,29,22,16,41,74,55.4,33,33,3,30,16,83,23,1
2489,Morten Thorsby,NOR,MF,Genoa,it  Serie A,28-310,1996.0,17.1,36,28,17,13,6,11,21,52.4,10,19,1,18,4,40,21,0
2490,Khéphren Thuram,FRA,MF,Juventus,it  Serie A,23-350,2001.0,17.2,25,10,8,17,0,14,22,63.6,8,18,6,12,8,33,29,0
2491,Marcus Thuram,FRA,FW,Inter,it  Serie A,27-217,1997.0,21.2,16,9,5,5,6,3,13,23.1,10,15,3,12,3,19,12,0
2492,Youri Tielemans,BEL,MF,Aston Villa,eng  Premier League,27-308,1997.0,27.7,70,48,26,39,5,32,61,52.5,29,33,14,19,21,91,36,3
2493,Kieran Tierney,SCO,"DF,FW",Arsenal,eng  Premier League,27-279,1997.0,0.9,2,1,1,0,1,0,2,0.0,2,0,0,0,1,3,2,0
2494,Phillip Tietz,GER,FW,Augsburg,de  Bundesliga,27-245,1997.0,15.0,11,6,2,7,2,5,8,62.5,3,7,1,6,4,15,22,0
2495,Jurriën Timber,NED,DF,Arsenal,eng  Premier League,23-267,2001.0,23.4,51,33,14,26,11,16,24,66.7,8,15,4,11,19,70,41,1
2496,Jean-Clair Todibo,FRA,DF,West Ham,eng  Premier League,25-071,1999.0,11.7,24,16,19,5,0,15,18,83.3,3,19,9,10,13,37,56,3
2497,Harry Toffolo,ENG,DF,Nott'ham Forest,eng  Premier League,29-204,1995.0,0.5,2,0,1,0,1,0,0,,0,0,0,0,1,3,7,0
2498,Umut Tohumcu,GER,MF,Hoffenheim,de  Bundesliga,20-212,2004.0,3.2,9,5,3,5,1,5,7,71.4,2,2,0,2,3,12,6,0
2499,Corentin Tolisso,FRA,MF,Lyon,fr  Ligue 1,30-220,1994.0,19.7,41,17,17,17,7,23,47,48.9,24,38,9,29,15,56,34,1
2500,John Tolkin,USA,"DF,FW",Holstein Kiel,de  Bundesliga,22-223,2002.0,2.0,3,1,3,0,0,2,3,66.7,1,2,1,1,1,4,12,0
2501,Rafael Tolói,ITA,DF,Atalanta,it  Serie A,34-152,1990.0,3.8,9,5,3,4,2,3,7,42.9,4,6,1,5,7,16,7,0
2502,Tiago Tomás,POR,"FW,MF",Wolfsburg,de  Bundesliga,22-268,2002.0,17.9,26,16,12,7,7,11,30,36.7,19,16,4,12,6,32,17,0
2503,Takehiro Tomiyasu,JPN,DF,Arsenal,eng  Premier League,26-126,1998.0,0.1,0,0,0,0,0,0,0,,0,0,0,0,0,0,1,0
2504,Fikayo Tomori,ENG,DF,Milan,it  Serie A,27-082,1997.0,10.8,22,16,11,10,1,7,12,58.3,5,9,7,2,11,33,36,0
2505,Sandro Tonali,ITA,MF,Newcastle Utd,eng  Premier League,24-307,2000.0,19.2,40,25,17,20,3,19,36,52.8,17,22,9,13,23,63,23,1
2506,Pablo Torre,ESP,"MF,FW",Barcelona,es  La Liga,21-342,2003.0,2.9,5,4,1,3,1,2,3,66.7,1,0,0,0,1,6,4,1
2507,David Torres,ESP,DF,Valladolid,es  La Liga,22-006,2003.0,14.4,13,8,12,1,0,7,11,63.6,4,18,16,2,10,23,68,0
2508,Ferrán Torres,ESP,"FW,MF",Barcelona,es  La Liga,25-010,2000.0,7.7,5,3,1,2,2,1,3,33.3,2,7,1,6,1,6,2,0
2509,Pau Torres,ESP,DF,Aston Villa,eng  Premier League,28-054,1997.0,17.2,18,13,11,6,1,9,14,64.3,5,13,9,4,6,24,49,2
2510,Lucas Torró,ESP,MF,Osasuna,es  La Liga,30-235,1994.0,22.5,47,28,15,29,3,24,47,51.1,23,29,6,23,32,79,43,3
2511,Lorenzo Tosto,ITA,DF,Empoli,it  Serie A,19-041,2006.0,0.0,0,0,0,0,0,0,0,,0,0,0,0,0,0,0,0
2512,Abdoulaye Touré,GUI,MF,Le Havre,fr  Ligue 1,31-008,1994.0,16.9,45,24,27,13,5,25,40,62.5,15,24,14,10,25,70,31,3
2513,Bazoumana Touré,CIV,"FW,MF",Hoffenheim,de  Bundesliga,19-009,2006.0,0.5,0,0,0,0,0,0,0,,0,0,0,0,3,3,0,0
2514,Birama Touré,MLI,"MF,DF",Montpellier,fr  Ligue 1,32-278,1992.0,3.3,8,5,5,2,1,4,6,66.7,2,3,2,1,6,14,7,0
2515,Ousmane Toure,FRA,DF,Lille,fr  Ligue 1,20-021,2005.0,0.1,0,0,0,0,0,0,0,,0,0,0,0,1,1,2,0
2516,Souleymane Touré,FRA,DF,Udinese,it  Serie A,21-348,2003.0,8.1,7,6,4,3,0,4,5,80.0,1,15,6,9,9,16,17,1
2517,Lucas Tousart,FRA,MF,Union Berlin,de  Bundesliga,27-316,1997.0,5.5,15,8,6,8,1,5,12,41.7,7,8,2,6,5,20,17,0
2518,Conor Townsend,ENG,DF,Ipswich Town,eng  Premier League,32-007,1993.0,1.5,7,5,6,1,0,5,7,71.4,2,4,3,1,3,10,7,0
2519,Adama Traoré,ESP,"FW,MF",Fulham,eng  Premier League,29-045,1996.0,15.3,14,9,7,2,5,5,13,38.5,8,5,0,5,1,15,4,2
2520,Hamari Traoré,MLI,DF,Real Sociedad,es  La Liga,33-043,1992.0,4.1,11,7,7,3,1,9,13,69.2,4,1,1,0,4,15,11,0
2521,Omar Traoré,GER,DF,Heidenheim,de  Bundesliga,27-035,1998.0,21.2,38,23,23,14,1,21,35,60.0,14,25,4,21,15,53,49,0
2522,Kevin Trapp,GER,GK,Eint Frankfurt,de  Bundesliga,34-246,1990.0,20.5,0,0,0,0,0,0,0,,0,0,0,0,0,0,9,3
2523,Mark Travers,IRL,GK,Bournemouth,eng  Premier League,25-297,1999.0,5.0,0,0,0,0,0,0,0,,0,0,0,0,0,0,5,0
2524,Óscar Trejo,ARG,"MF,FW",Rayo Vallecano,es  La Liga,36-319,1988.0,4.0,5,4,0,4,1,3,6,50.0,3,4,0,4,3,8,3,0
2525,Philipp Treu,GER,"MF,DF",St. Pauli,de  Bundesliga,24-098,2000.0,23.4,50,36,28,14,8,30,57,52.6,27,44,8,36,15,65,57,2
2526,Ryan Trevitt,ENG,MF,Brentford,eng  Premier League,21-364,2003.0,0.0,1,1,1,0,0,0,0,,0,0,0,0,0,1,0,0
2527,Christopher Trimmel,AUT,"DF,MF",Union Berlin,de  Bundesliga,38-015,1987.0,12.0,25,17,15,9,1,20,30,66.7,10,11,4,7,11,36,45,0
2528,Kieran Trippier,ENG,DF,Newcastle Utd,eng  Premier League,34-173,1990.0,7.8,16,9,7,7,2,7,18,38.9,11,4,1,3,10,26,24,0
2529,Leandro Trossard,BEL,FW,Arsenal,eng  Premier League,30-097,1994.0,20.1,24,16,5,14,5,8,26,30.8,18,23,0,23,9,33,16,0
2530,Adrien Truffert,FRA,"DF,MF",Rennes,fr  Ligue 1,23-111,2001.0,21.6,45,24,19,16,10,24,37,64.9,13,35,5,30,21,66,43,0
2531,Kostas Tsimikas,GRE,DF,Liverpool,eng  Premier League,28-303,1996.0,5.7,23,14,11,9,3,12,15,80.0,3,5,2,3,7,30,16,0
2532,Viktor Tsyhankov,UKR,"FW,MF",Girona,es  La Liga,27-116,1997.0,12.1,12,10,2,2,8,5,11,45.5,6,3,0,3,9,21,9,1
2533,Axel Tuanzebe,COD,DF,Ipswich Town,eng  Premier League,27-117,1997.0,12.2,24,13,15,3,6,13,20,65.0,7,10,5,5,17,41,35,0
2534,Stefano Turati,ITA,GK,Monza,it  Serie A,23-187,2001.0,23.7,0,0,0,0,0,0,1,0.0,1,0,0,0,0,0,15,1
2535,Beñat Turrientes,ESP,MF,Real Sociedad,es  La Liga,23-039,2002.0,7.9,12,4,4,7,1,3,9,33.3,6,14,2,12,4,16,10,0
2536,Tuta,BRA,"DF,MF",Eint Frankfurt,de  Bundesliga,25-250,1999.0,18.2,27,17,15,10,2,19,30,63.3,11,33,18,15,32,59,108,1
2537,Chrisantus Uche,NGA,"FW,MF",Getafe,es  La Liga,21-296,2003.0,21.9,23,14,3,14,6,5,12,41.7,7,15,2,13,7,30,15,0
2538,Destiny Udogie,ITA,DF,Tottenham,eng  Premier League,22-103,2002.0,17.4,60,37,28,25,7,28,39,71.8,11,33,5,28,18,78,26,1
2539,Manuel Ugarte Ribeiro,URU,MF,Manchester Utd,eng  Premier League,23-334,2001.0,14.0,59,35,25,28,6,20,46,43.5,26,20,3,17,19,78,13,1
2540,Lesley Ugochukwu,FRA,MF,Southampton,eng  Premier League,20-350,2004.0,10.5,38,18,11,24,3,13,27,48.1,14,17,6,11,5,43,13,1
2541,Lukas Ullrich,GER,DF,Gladbach,de  Bundesliga,20-360,2004.0,14.1,13,4,10,2,1,7,19,36.8,12,20,6,14,15,28,45,1
2542,Sven Ulreich,GER,GK,Bayern Munich,de  Bundesliga,36-220,1988.0,1.0,0,0,0,0,0,0,0,,0,0,0,0,0,0,0,0
2543,Enes Ünal,TUR,"FW,MF",Bournemouth,eng  Premier League,27-305,1997.0,3.8,1,0,0,0,1,0,3,0.0,3,1,0,1,0,1,6,0
2544,Deniz Undav,GER,"FW,MF",Stuttgart,de  Bundesliga,28-235,1996.0,13.7,7,6,1,1,5,0,11,0.0,11,6,0,6,3,10,7,0
2545,Naci Ünüvar,NED,"MF,DF",Espanyol,es  La Liga,21-271,2003.0,0.3,2,2,1,1,0,1,2,50.0,1,0,0,0,0,2,0,0
2546,Dayot Upamecano,FRA,DF,Bayern Munich,de  Bundesliga,26-135,1998.0,18.5,32,21,17,13,2,16,29,55.2,13,17,7,10,31,63,43,1
2547,Kacper Urbanski,POL,MF,Bologna,it  Serie A,20-185,2004.0,2.7,5,2,4,0,1,4,6,66.7,2,5,1,4,2,7,5,0
2548,Kacper Urbanski,POL,MF,Monza,it  Serie A,20-185,2004.0,4.6,4,2,1,1,2,4,7,57.1,3,7,2,5,2,6,8,0
2549,Jonas Urbig,GER,GK,Bayern Munich,de  Bundesliga,21-215,2003.0,1.0,0,0,0,0,0,0,0,,0,0,0,0,0,0,1,0
2550,Can Uzun,TUR,"MF,FW",Eint Frankfurt,de  Bundesliga,19-120,2005.0,6.3,8,3,1,3,4,5,9,55.6,4,8,0,8,1,9,3,0
2551,Josha Vagnoman,GER,"DF,MF",Stuttgart,de  Bundesliga,24-090,2000.0,18.7,23,11,10,11,2,16,29,55.2,13,15,2,13,12,35,54,1
2552,Lautaro Valenti,ARG,DF,Parma,it  Serie A,26-056,1999.0,9.0,11,8,9,2,0,4,4,100.0,0,11,6,5,5,16,53,0
2553,Óscar Valentín,ESP,MF,Rayo Vallecano,es  La Liga,30-203,1994.0,16.1,46,36,20,17,9,27,58,46.6,31,29,5,24,21,67,44,1
2554,Nicolás Valentini,ARG,DF,Hellas Verona,it  Serie A,23-339,2001.0,4.0,18,12,11,6,1,12,15,80.0,3,6,4,2,4,22,27,0
2555,Germán Valera,ESP,MF,Valencia,es  La Liga,22-360,2002.0,1.6,1,1,1,0,0,0,1,0.0,1,2,0,2,4,5,2,1
2556,Emanuele Valeri,ITA,DF,Parma,it  Serie A,26-094,1998.0,22.5,37,23,24,10,3,23,39,59.0,16,19,6,13,22,59,74,3
2557,Martin Valjent,SVK,DF,Mallorca,es  La Liga,29-090,1995.0,21.7,21,15,16,4,1,9,11,81.8,2,18,11,7,15,36,128,1
2558,Álex Valle,ESP,DF,Como,it  Serie A,20-320,2004.0,5.5,14,9,5,9,0,7,11,63.6,4,8,2,6,5,19,20,0
2559,Jesús Vallejo,ESP,DF,Real Madrid,es  La Liga,28-065,1997.0,0.1,0,0,0,0,0,0,0,,0,0,0,0,0,0,2,0
2560,Mattia Valoti,ITA,MF,Monza,it  Serie A,31-186,1993.0,0.4,3,3,3,0,0,0,2,0.0,2,2,0,2,0,3,2,0
2561,Federico Valverde,URU,"MF,DF",Real Madrid,es  La Liga,26-232,1998.0,23.6,32,20,13,14,5,17,27,63.0,10,26,4,22,44,76,31,1
2562,Ignace Van Der Brempt,BEL,DF,Como,it  Serie A,22-344,2002.0,11.5,37,30,25,10,2,21,29,72.4,8,11,5,6,10,47,30,0
2563,Siebe Van Der Heyden,BEL,"DF,MF",Mallorca,es  La Liga,26-285,1998.0,1.1,1,1,0,1,0,0,0,,0,1,0,1,2,3,3,0
2564,Siebe Van Der Heyden,BEL,"DF,MF",St. Pauli,de  Bundesliga,26-285,1998.0,4.6,12,7,7,5,0,6,12,50.0,6,3,1,2,9,21,22,0
2565,Virgil van Dijk,NED,DF,Liverpool,eng  Premier League,33-246,1991.0,29.0,32,14,16,14,2,9,16,56.3,7,22,12,10,44,76,143,3
2566,Vanderson,BRA,DF,Monaco,fr  Ligue 1,23-263,2001.0,17.8,58,33,27,25,6,35,49,71.4,14,34,6,28,32,90,49,1
2567,Maarten Vandevoordt,BEL,GK,RB Leipzig,de  Bundesliga,23-013,2002.0,1.5,0,0,0,0,0,0,0,,0,0,0,0,0,0,2,0
2568,Jamie Vardy,ENG,FW,Leicester City,eng  Premier League,38-059,1987.0,23.7,13,11,6,4,3,2,9,22.2,7,8,4,4,3,16,18,0
2569,Ruben Vargas,SUI,FW,Sevilla,es  La Liga,26-218,1998.0,6.2,6,4,1,4,1,2,6,33.3,4,8,0,8,1,7,8,0
2570,Ruben Vargas,SUI,"MF,FW",Augsburg,de  Bundesliga,26-218,1998.0,3.4,2,1,1,1,0,1,4,25.0,3,1,0,1,2,4,1,1
2571,Nikola Vasilj,BIH,GK,St. Pauli,de  Bundesliga,29-099,1995.0,25.0,0,0,0,0,0,0,2,0.0,2,0,0,0,0,0,18,2
2572,Devis Vásquez,COL,GK,Empoli,it  Serie A,26-303,1998.0,23.0,0,0,0,0,0,0,0,,0,0,0,0,0,0,16,3
2573,Johan Vásquez,MEX,DF,Genoa,it  Serie A,26-140,1998.0,25.5,33,16,15,15,3,12,25,48.0,13,50,24,26,36,69,115,1
2574,Denis Vavro,SVK,DF,Wolfsburg,de  Bundesliga,28-335,1996.0,20.0,12,8,9,3,0,4,14,28.6,10,32,20,12,24,36,173,3
2575,José Luis García Vayá,ESP,MF,Valencia,es  La Liga,26-212,1998.0,15.5,35,20,18,11,6,13,25,52.0,12,17,6,11,12,47,25,0
2576,Robinio Vaz,FRA,FW,Marseille,fr  Ligue 1,18-022,2007.0,0.8,1,1,0,0,1,0,2,0.0,2,0,0,0,0,1,2,0
2577,Jesus Vazquez,ESP,DF,Valencia,es  La Liga,22-068,2003.0,7.6,16,13,8,6,2,5,12,41.7,7,14,5,9,5,21,22,0
2578,Lucas Vázquez,ESP,DF,Real Madrid,es  La Liga,33-253,1991.0,16.6,41,25,26,10,5,20,38,52.6,18,10,1,9,13,54,19,0
2579,Matías Vecino,URU,MF,Lazio,it  Serie A,33-199,1991.0,6.5,11,6,3,7,1,4,16,25.0,12,6,2,4,5,16,8,0
2580,Danilo Veiga,POR,"DF,FW",Lecce,it  Serie A,22-167,2002.0,0.4,2,2,1,1,0,1,2,50.0,1,0,0,0,2,4,1,0
2581,Renato Veiga,POR,"DF,MF",Chelsea,eng  Premier League,21-225,2003.0,2.0,9,6,6,3,0,4,12,33.3,8,3,1,2,1,10,2,0
2582,Renato Veiga,POR,DF,Juventus,it  Serie A,21-225,2003.0,3.0,4,4,2,2,0,1,3,33.3,2,5,4,1,7,11,17,0
2583,Alejo Véliz,ARG,FW,Espanyol,es  La Liga,21-173,2003.0,10.5,1,1,0,1,0,1,6,16.7,5,11,2,9,3,4,19,1
2584,Miloš Veljković,SRB,DF,Werder Bremen,de  Bundesliga,29-166,1995.0,10.5,10,5,6,3,1,7,15,46.7,8,13,9,4,2,12,46,1
2585,Joël Veltman,NED,DF,Brighton,eng  Premier League,33-055,1992.0,18.3,42,28,23,16,3,30,51,58.8,21,22,7,15,18,60,66,0
2586,Micky van de Ven,NED,DF,Tottenham,eng  Premier League,23-326,2001.0,9.1,8,5,3,4,1,6,11,54.5,5,9,6,3,9,17,30,1
2587,Lorenzo Venturino,ITA,"FW,MF",Genoa,it  Serie A,18-262,2006.0,0.4,2,1,1,0,1,1,1,100.0,0,1,0,1,0,2,0,0
2588,Nikolas Veratschnig,AUT,"DF,FW",Mainz 05,de  Bundesliga,22-046,2003.0,0.7,2,2,1,1,0,1,1,100.0,0,1,0,1,1,3,1,0
2589,Bart Verbruggen,NED,GK,Brighton,eng  Premier League,22-205,2002.0,26.0,0,0,0,0,0,0,2,0.0,2,1,0,1,0,0,18,4
2590,Simone Verdi,ITA,"MF,FW",Como,it  Serie A,32-242,1992.0,1.3,2,2,0,1,1,0,2,0.0,2,2,0,2,0,2,2,0
2591,Jordan Veretout,FRA,MF,Lyon,fr  Ligue 1,32-010,1993.0,13.6,19,9,10,7,2,11,30,36.7,19,11,2,9,3,22,20,0
2592,Arthur Vermeeren,BEL,MF,RB Leipzig,de  Bundesliga,20-032,2005.0,13.2,26,17,13,11,2,10,39,25.6,29,29,9,20,22,48,17,1
2593,Yorbe Vertessen,BEL,"MF,FW",Union Berlin,de  Bundesliga,24-062,2001.0,8.0,6,3,3,2,1,2,8,25.0,6,6,0,6,3,9,6,0
2594,Mikel Vesga,ESP,MF,Athletic Club,es  La Liga,31-294,1993.0,7.9,18,12,6,11,1,9,22,40.9,13,7,0,7,10,28,12,0
2595,Jannik Vestergaard,DEN,DF,Leicester City,eng  Premier League,32-220,1992.0,15.5,22,10,16,6,0,9,15,60.0,6,21,14,7,16,38,74,1
2596,Ben Viadere,FRA,MF,Auxerre,fr  Ligue 1,19-190,2005.0,0.1,0,0,0,0,0,0,0,,0,0,0,0,0,0,0,0
2597,Guglielmo Vicario,ITA,GK,Tottenham,eng  Premier League,28-155,1996.0,16.0,0,0,0,0,0,0,0,,0,0,0,0,1,1,7,2
2598,Carlos Vicente,ESP,"FW,MF",Alavés,es  La Liga,25-322,1999.0,24.2,26,18,18,4,4,14,30,46.7,16,21,2,19,11,37,23,0
2599,Pau Victor Delgado,ESP,FW,Barcelona,es  La Liga,23-105,2001.0,2.4,1,1,0,1,0,0,3,0.0,3,6,1,5,2,3,4,0
2600,Nacho Vidal,ESP,DF,Osasuna,es  La Liga,30-046,1995.0,1.4,2,0,0,1,1,1,4,25.0,3,1,0,1,0,2,6,0
2601,Gabriel Vidovic,CRO,MF,Mainz 05,de  Bundesliga,21-100,2003.0,0.0,0,0,0,0,0,0,0,,0,0,0,0,0,0,0,0
2602,Fran Vieites,ESP,GK,Betis,es  La Liga,25-308,1999.0,4.0,0,0,0,0,0,0,0,,0,0,0,0,0,0,1,0
2603,Samuele Vignato,ITA,MF,Monza,it  Serie A,21-015,2004.0,4.7,6,3,0,4,2,3,6,50.0,3,0,0,0,0,6,6,0
2604,Asier Villalibre,ESP,FW,Alavés,es  La Liga,27-162,1997.0,3.1,1,1,0,0,1,1,2,50.0,1,1,0,1,1,2,5,0
2605,Iván Villar,ESP,GK,Celta Vigo,es  La Liga,27-245,1997.0,4.0,0,0,0,0,0,0,0,,0,0,0,0,0,0,3,0
2606,Carlos Vinícius,BRA,MF,Fulham,eng  Premier League,29-351,1995.0,0.0,0,0,0,0,0,0,0,,0,0,0,0,0,0,0,0
2607,Nicolas Viola,ITA,"MF,FW",Cagliari,it  Serie A,35-150,1989.0,10.1,13,7,6,7,0,1,9,11.1,8,4,0,4,2,15,4,0
2608,Viti,ESP,DF,Las Palmas,es  La Liga,27-176,1997.0,14.0,47,32,28,16,3,21,29,72.4,8,18,4,14,20,67,41,0
2609,Mattia Viti,ITA,DF,Empoli,it  Serie A,23-046,2002.0,20.2,49,35,33,14,2,30,41,73.2,11,32,15,17,38,87,81,3
2610,Vitinha,POR,"FW,MF",Genoa,it  Serie A,24-361,2000.0,10.5,15,5,6,4,5,8,23,34.8,15,11,1,10,11,26,15,0
2611,Vitinha,POR,MF,Paris S-G,fr  Ligue 1,25-026,2000.0,17.0,33,17,11,20,2,21,38,55.3,17,20,5,15,10,43,13,2
2612,Daniel Vivian,ESP,DF,Athletic Club,es  La Liga,25-239,1999.0,21.6,33,21,18,13,2,17,26,65.4,9,18,7,11,31,64,98,0
2613,Dušan Vlahović,SRB,FW,Juventus,it  Serie A,25-042,2000.0,16.4,2,1,0,1,1,1,4,25.0,3,7,3,4,1,3,8,3
2614,Vanja Vlahović,SRB,"FW,MF",Atalanta,it  Serie A,20-353,2004.0,0.7,1,1,0,0,1,0,0,,0,0,0,0,0,1,0,0
2615,Nikola Vlašić,CRO,"MF,FW",Torino,it  Serie A,27-158,1997.0,16.7,30,15,10,13,7,11,25,44.0,14,12,3,9,8,38,12,0
2616,Alessandro Vogliacco,ITA,DF,Genoa,it  Serie A,26-178,1998.0,7.9,15,3,7,7,1,10,12,83.3,2,11,7,4,9,24,20,0
2617,Alessandro Vogliacco,ITA,DF,Parma,it  Serie A,26-178,1998.0,5.5,2,0,2,0,0,0,1,0.0,1,11,9,2,2,4,21,0
2618,Kevin Vogt,GER,DF,Union Berlin,de  Bundesliga,33-169,1991.0,13.3,9,6,6,3,0,7,11,63.6,4,15,8,7,9,18,64,0
2619,Mërgim Vojvoda,KVX,DF,Torino,it  Serie A,30-038,1995.0,12.3,18,10,5,9,4,7,14,50.0,7,13,3,10,7,25,24,1
2620,Mërgim Vojvoda,KVX,DF,Como,it  Serie A,30-038,1995.0,0.4,0,0,0,0,0,0,0,,0,1,1,0,1,1,1,0
2621,Kevin Volland,GER,"FW,MF",Union Berlin,de  Bundesliga,32-224,1992.0,0.6,0,0,0,0,0,0,0,,0,0,0,0,0,0,1,0
2622,Aster Vranckx,BEL,MF,Wolfsburg,de  Bundesliga,22-158,2002.0,3.7,7,4,2,5,0,2,5,40.0,3,9,2,7,6,13,7,0
2623,Stefan de Vrij,NED,DF,Inter,it  Serie A,33-034,1992.0,15.2,16,10,11,4,1,8,11,72.7,3,16,9,7,19,35,58,0
2624,Ibrahima Wadji,SEN,"MF,FW",Saint-Étienne,fr  Ligue 1,29-310,1995.0,1.2,4,4,1,2,1,3,7,42.9,4,0,0,0,0,4,0,0
2625,Robert Wagner,GER,MF,St. Pauli,de  Bundesliga,21-240,2003.0,4.0,7,2,1,6,0,3,10,30.0,7,6,0,6,1,8,9,0
2626,Elye Wahi,FRA,FW,Marseille,fr  Ligue 1,22-068,2003.0,6.4,0,0,0,0,0,0,4,0.0,4,1,0,1,1,1,0,0
2627,Elye Wahi,FRA,"FW,MF",Eint Frankfurt,de  Bundesliga,22-068,2003.0,1.8,0,0,0,0,0,0,1,0.0,1,1,0,1,0,0,1,0
2628,Hauke Wahl,GER,DF,St. Pauli,de  Bundesliga,30-330,1994.0,25.0,28,21,15,11,2,16,28,57.1,12,33,21,12,27,55,117,3
2629,Kyle Walker,ENG,DF,Manchester City,eng  Premier League,34-287,1990.0,10.8,17,10,7,7,3,14,26,53.8,12,13,4,9,3,20,13,1
2630,Kyle Walker,ENG,DF,Milan,it  Serie A,34-287,1990.0,3.8,11,6,8,3,0,8,11,72.7,3,7,4,3,2,13,9,0
2631,Kyle Walker-Peters,ENG,DF,Southampton,eng  Premier League,27-332,1997.0,25.4,35,22,20,10,5,13,30,43.3,17,24,14,10,14,49,69,1
2632,Christian Walton,ENG,GK,Ipswich Town,eng  Premier League,29-122,1995.0,6.0,0,0,0,0,0,0,1,0.0,1,0,0,0,0,0,1,1
2633,Sebastian Walukiewicz,POL,DF,Torino,it  Serie A,24-340,2000.0,14.7,22,12,12,7,3,12,19,63.2,7,17,5,12,17,39,50,0
2634,Sebastian Walukiewicz,POL,DF,Empoli,it  Serie A,24-340,2000.0,2.0,1,0,1,0,0,0,1,0.0,1,3,3,0,1,2,15,0
2635,Aaron Wan-Bissaka,ENG,DF,West Ham,eng  Premier League,27-105,1997.0,26.0,50,35,24,22,4,14,20,70.0,6,27,8,19,46,96,89,0
2636,Paul Wanner,GER,"MF,FW",Heidenheim,de  Bundesliga,19-078,2005.0,16.8,31,21,14,17,0,13,29,44.8,16,13,0,13,4,35,16,0
2637,Danny Ward,WAL,GK,Leicester City,eng  Premier League,31-262,1993.0,1.5,0,0,0,0,0,0,0,,0,0,0,0,0,0,1,0
2638,James Ward-Prowse,ENG,MF,West Ham,eng  Premier League,30-130,1994.0,3.6,7,5,4,1,2,3,9,33.3,6,5,3,2,4,11,6,0
2639,James Ward-Prowse,ENG,MF,Nott'ham Forest,eng  Premier League,30-130,1994.0,4.4,4,1,1,3,0,2,2,100.0,0,3,2,1,5,9,8,0
2640,Kjell-Arik Wätjen,GER,MF,Dortmund,de  Bundesliga,19-023,2006.0,0.2,0,0,0,0,0,0,0,,0,0,0,0,0,0,2,0
2641,Ollie Watkins,ENG,FW,Aston Villa,eng  Premier League,29-071,1995.0,22.8,6,4,0,4,2,1,8,12.5,7,11,3,8,6,12,13,2
2642,Timothy Weah,USA,"FW,DF",Juventus,it  Serie A,25-017,2000.0,13.6,26,15,9,11,6,10,16,62.5,6,19,4,15,11,37,16,1
2643,Adam Webster,ENG,DF,Brighton,eng  Premier League,30-066,1995.0,5.9,7,5,3,3,1,4,9,44.4,5,11,8,3,13,20,25,1
2644,Julian Weigl,GER,MF,Gladbach,de  Bundesliga,29-184,1995.0,23.3,41,18,18,19,4,22,34,64.7,12,37,15,22,37,78,60,0
2645,Timon Weiner,GER,GK,Holstein Kiel,de  Bundesliga,26-052,1999.0,24.0,0,0,0,0,0,0,1,0.0,1,0,0,0,0,0,15,3
2646,Nelson Weiper,GER,FW,Mainz 05,de  Bundesliga,19-359,2005.0,5.2,4,4,2,2,0,2,4,50.0,2,3,0,3,1,5,3,1
2647,Mitchell Weiser,GER,"DF,MF",Werder Bremen,de  Bundesliga,30-324,1994.0,23.9,50,34,15,27,8,22,41,53.7,19,20,0,20,17,67,47,2
2648,Noah Weißhaupt,GER,"FW,MF",St. Pauli,de  Bundesliga,23-172,2001.0,7.6,5,3,2,0,3,3,7,42.9,4,5,0,5,1,6,6,0
2649,Noah Weißhaupt,GER,FW,Freiburg,de  Bundesliga,23-172,2001.0,0.9,0,0,0,0,0,0,1,0.0,1,0,0,0,0,0,1,0
2650,Danny Welbeck,ENG,FW,Brighton,eng  Premier League,34-105,1990.0,16.3,15,8,3,11,1,3,11,27.3,8,12,1,11,5,20,9,0
2651,Welington,BRA,"DF,MF",Southampton,eng  Premier League,24-020,2001.0,1.9,10,2,7,2,1,6,10,60.0,4,3,1,2,3,13,11,0
2652,Timo Werner,GER,"FW,MF",Tottenham,eng  Premier League,29-005,1996.0,5.7,6,4,3,3,0,3,13,23.1,10,10,1,9,1,7,7,0
2653,Adam Wharton,ENG,MF,Crystal Palace,eng  Premier League,20-282,2004.0,9.4,28,12,11,14,3,13,32,40.6,19,8,1,7,13,41,18,0
2654,Ben White,ENG,DF,Arsenal,eng  Premier League,27-154,1997.0,7.8,10,6,8,1,1,9,21,42.9,12,7,6,1,11,21,23,0
2655,Silvan Widmer,SUI,DF,Mainz 05,de  Bundesliga,32-006,1993.0,3.7,8,4,1,6,1,6,9,66.7,3,5,1,4,3,11,19,0
2656,Mats Wieffer,NED,MF,Brighton,eng  Premier League,25-115,1999.0,5.4,23,12,5,15,3,9,16,56.3,7,10,1,9,8,31,13,2
2657,Mateusz Wieteska,POL,DF,Cagliari,it  Serie A,28-028,1997.0,2.0,1,0,0,1,0,1,1,100.0,0,3,2,1,7,8,6,0
2658,Caleb Wiley,USA,"DF,MF",Strasbourg,fr  Ligue 1,20-079,2004.0,3.0,1,0,0,1,0,0,1,0.0,1,3,1,2,4,5,5,0
2659,Iñaki Williams,GHA,"FW,MF",Athletic Club,es  La Liga,30-269,1994.0,23.7,17,10,4,8,5,12,21,57.1,9,26,3,23,12,29,25,0
2660,Neco Williams,WAL,DF,Nott'ham Forest,eng  Premier League,23-332,2001.0,18.8,55,33,43,8,4,31,54,57.4,23,31,5,26,23,78,81,0
2661,Nico Williams,ESP,FW,Athletic Club,es  La Liga,22-242,2002.0,18.8,24,15,9,9,6,9,26,34.6,17,16,1,15,5,29,8,0
2662,Willian,BRA,MF,Fulham,eng  Premier League,36-214,1988.0,0.5,0,0,0,0,0,0,0,,0,0,0,0,1,1,1,0
2663,Joe Willock,ENG,"MF,FW",Newcastle Utd,eng  Premier League,25-203,1999.0,9.1,21,12,12,6,3,17,26,65.4,9,18,3,15,5,26,7,0
2664,Callum Wilson,ENG,"FW,MF",Newcastle Utd,eng  Premier League,33-012,1992.0,1.8,1,1,0,1,0,0,1,0.0,1,2,0,2,1,2,0,0
2665,Harry Wilson,WAL,"FW,MF",Fulham,eng  Premier League,27-354,1997.0,9.3,10,6,6,3,1,6,11,54.5,5,13,1,12,5,15,5,1
2666,Patrick Wimmer,AUT,"MF,FW",Wolfsburg,de  Bundesliga,23-285,2001.0,12.6,30,22,15,10,5,12,30,40.0,18,22,2,20,22,52,9,0
2667,Jonas Wind,DEN,"FW,MF",Wolfsburg,de  Bundesliga,26-032,1999.0,15.7,5,4,1,4,0,2,5,40.0,3,12,3,9,4,9,9,0
2668,Harry Winks,ENG,MF,Leicester City,eng  Premier League,29-037,1996.0,16.8,24,11,12,10,2,13,30,43.3,17,16,6,10,9,33,20,0
2669,Ben Winterburn,ENG,MF,Bournemouth,eng  Premier League,20-188,2004.0,0.1,0,0,0,0,0,0,1,0.0,1,0,0,0,0,0,0,0
2670,Florian Wirtz,GER,"MF,FW",Leverkusen,de  Bundesliga,21-312,2003.0,20.8,29,18,10,11,8,8,19,42.1,11,23,1,22,8,37,4,0
2671,Yoane Wissa,COD,FW,Brentford,eng  Premier League,28-189,1996.0,22.4,12,6,5,2,5,6,14,42.9,8,20,5,15,6,18,17,2
2672,Dani de Wit,NED,"MF,FW",Bochum,de  Bundesliga,27-042,1998.0,11.1,23,13,7,13,3,14,25,56.0,11,15,4,11,11,34,20,1
2673,Axel Witsel,BEL,DF,Atlético Madrid,es  La Liga,36-058,1989.0,8.5,13,12,4,8,1,10,12,83.3,2,15,8,7,9,22,32,1
2674,Maximilian Wittek,GER,DF,Bochum,de  Bundesliga,29-202,1995.0,21.1,42,31,27,11,4,28,40,70.0,12,44,8,36,17,59,59,2
2675,Marius Wolf,GER,DF,Augsburg,de  Bundesliga,29-288,1995.0,17.6,22,14,9,10,3,14,31,45.2,17,23,5,18,15,37,39,1
2676,Nick Woltemade,GER,"FW,MF",Stuttgart,de  Bundesliga,23-025,2002.0,11.9,4,2,2,1,1,2,5,40.0,3,15,1,14,1,5,9,1
2677,Jeong Woo-yeong,KOR,"MF,FW",Union Berlin,de  Bundesliga,25-172,1999.0,13.1,8,6,3,5,0,2,7,28.6,5,7,1,6,10,18,9,0
2678,Chris Wood,NZL,FW,Nott'ham Forest,eng  Premier League,33-094,1991.0,25.2,4,4,1,1,2,1,8,12.5,7,10,6,4,4,8,18,1
2679,Nathan Wood-Gordon,ENG,DF,Southampton,eng  Premier League,22-284,2002.0,6.9,10,7,6,3,1,5,8,62.5,3,8,5,3,4,14,26,2
2680,Christopher Wooh,CMR,DF,Rennes,fr  Ligue 1,23-174,2001.0,15.5,33,16,19,12,2,16,22,72.7,6,22,8,14,23,56,63,0
2681,Luke Woolfenden,ENG,DF,Ipswich Town,eng  Premier League,26-141,1998.0,10.2,7,4,4,3,0,2,5,40.0,3,17,11,6,17,24,58,0
2682,Granit Xhaka,SUI,MF,Leverkusen,de  Bundesliga,32-165,1992.0,24.2,36,22,11,19,6,19,32,59.4,13,24,5,19,8,44,31,1
2683,Lamine Yamal,ESP,FW,Barcelona,es  La Liga,17-241,2007.0,20.8,29,21,5,12,12,12,22,54.5,10,8,0,8,11,40,3,0
2684,Daniel Yáñez,ESP,FW,Real Madrid,es  La Liga,17-348,2007.0,0.0,0,0,0,0,0,0,0,,0,0,0,0,0,0,0,0
2685,Erencan Yardimci,TUR,"FW,MF",Hoffenheim,de  Bundesliga,23-035,2002.0,3.3,4,3,1,3,0,1,2,50.0,1,2,0,2,1,5,2,0
2686,Yehor Yarmoliuk,UKR,MF,Brentford,eng  Premier League,21-010,2004.0,8.6,26,17,11,11,4,16,34,47.1,18,22,6,16,8,34,23,0
2687,Ryan Yates,ENG,MF,Nott'ham Forest,eng  Premier League,27-110,1997.0,16.9,34,18,20,10,4,13,29,44.8,16,24,4,20,20,54,46,1
2688,John Yeboah,ECU,"FW,MF",Venezia,it  Serie A,24-261,2000.0,7.6,4,3,1,2,1,0,8,0.0,8,4,0,4,3,7,1,0
2689,Bertuğ Yıldırım,TUR,FW,Getafe,es  La Liga,22-242,2002.0,10.3,6,3,0,5,1,1,6,16.7,5,9,2,7,1,7,12,0
2690,Kenan Yıldız,TUR,"FW,MF",Juventus,it  Serie A,19-311,2005.0,20.8,48,26,11,23,14,16,24,66.7,8,21,0,21,4,52,10,3
2691,Leny Yoro,FRA,DF,Manchester Utd,eng  Premier League,19-118,2005.0,7.8,18,7,13,4,1,6,12,50.0,6,4,2,2,13,31,26,0
2692,Ashley Young,ENG,"DF,FW",Everton,eng  Premier League,39-245,1985.0,17.3,48,27,22,19,7,29,47,61.7,18,9,3,6,22,70,56,1
2693,Etienne Youte Kinkoue,FRA,DF,Le Havre,fr  Ligue 1,23-056,2002.0,19.5,15,7,8,6,1,10,15,66.7,5,31,19,12,20,35,123,2
2694,Illia Zabarnyi,UKR,DF,Bournemouth,eng  Premier League,22-191,2002.0,25.3,40,26,21,18,1,26,37,70.3,11,30,19,11,28,68,128,2
2695,Eloge Zabi,CIV,"DF,MF",Reims,fr  Ligue 1,18-168,2006.0,0.2,0,0,0,0,0,0,0,,0,0,0,0,0,0,1,0
2696,Mattia Zaccagni,ITA,FW,Lazio,it  Serie A,29-268,1995.0,22.2,27,20,8,15,4,11,23,47.8,12,11,1,10,19,46,14,0
2697,Dan-Axel Zagadou,FRA,"DF,MF",Stuttgart,de  Bundesliga,25-281,1999.0,0.3,0,0,0,0,0,0,0,,0,0,0,0,1,1,1,0
2698,Yoram Zague,FRA,DF,Paris S-G,fr  Ligue 1,18-300,2006.0,1.8,4,3,2,1,1,2,3,66.7,1,2,0,2,2,6,2,0
2699,Wilfried Zaha,CIV,FW,Lyon,fr  Ligue 1,32-121,1992.0,0.8,1,1,1,0,0,1,2,50.0,1,3,0,3,1,2,0,0
2700,Warren Zaïre-Emery,FRA,"MF,DF",Paris S-G,fr  Ligue 1,19-003,2006.0,16.1,38,18,14,14,10,17,34,50.0,17,26,4,22,17,55,15,2
2701,Miha Zajc,SVN,MF,Toulouse,fr  Ligue 1,30-253,1994.0,2.5,3,3,1,1,1,3,5,60.0,2,1,1,0,3,6,6,0
2702,Denis Zakaria,SUI,MF,Monaco,fr  Ligue 1,28-111,1996.0,15.8,27,16,8,16,3,15,22,68.2,7,19,7,12,19,46,27,1
2703,Arsen Zakharyan,RUS,"MF,FW",Real Sociedad,es  La Liga,21-289,2003.0,0.8,1,1,1,0,0,1,1,100.0,0,1,1,0,1,2,0,0
2704,Nicola Zalewski,POL,"DF,FW",Roma,it  Serie A,23-047,2002.0,5.9,8,6,3,2,3,2,7,28.6,5,7,2,5,4,12,8,2
2705,Nicola Zalewski,POL,DF,Inter,it  Serie A,23-047,2002.0,0.8,2,1,2,0,0,2,3,66.7,1,1,0,1,0,2,1,0
2706,Andre-Frank Zambo Anguissa,CMR,MF,Napoli,it  Serie A,29-115,1995.0,24.8,36,24,5,26,5,11,28,39.3,17,15,4,11,27,63,28,1
2707,Francesco Zampano,ITA,DF,Venezia,it  Serie A,31-162,1993.0,17.8,29,20,18,9,2,14,28,50.0,14,20,0,20,6,35,28,2
2708,Nicolò Zaniolo,ITA,FW,Fiorentina,it  Serie A,25-252,1999.0,2.8,2,1,1,1,0,0,2,0.0,2,1,1,0,0,2,1,0
2709,Nicolò Zaniolo,ITA,"FW,MF",Atalanta,it  Serie A,25-252,1999.0,4.0,0,0,0,0,0,0,2,0.0,2,0,0,0,1,1,0,0
2710,Alessandro Zanoli,ITA,"FW,DF",Genoa,it  Serie A,24-159,2000.0,14.9,25,17,11,12,2,9,18,50.0,9,14,2,12,9,34,38,0
2711,Duván Zapata,COL,FW,Torino,it  Serie A,33-344,1991.0,6.5,7,5,2,0,5,0,3,0.0,3,2,1,1,2,9,7,0
2712,Gabriele Zappa,ITA,DF,Cagliari,it  Serie A,25-079,1999.0,27.3,33,19,17,14,2,16,26,61.5,10,37,20,17,17,50,72,1
2713,Davide Zappacosta,ITA,DF,Atalanta,it  Serie A,32-273,1992.0,15.4,15,8,9,3,3,12,23,52.2,11,17,4,13,10,25,18,2
2714,Bryan Zaragoza,ESP,"FW,MF",Osasuna,es  La Liga,23-320,2001.0,14.9,12,8,8,3,1,5,18,27.8,13,8,0,8,1,13,8,0
2715,Anass Zaroury,MAR,"FW,MF",Lens,fr  Ligue 1,24-124,2000.0,10.8,16,14,4,9,3,7,19,36.8,12,7,0,7,3,19,10,0
2716,Oier Zarraga,ESP,MF,Udinese,it  Serie A,26-066,1999.0,6.1,14,9,7,7,0,8,17,47.1,9,5,2,3,2,16,5,0
2717,David Zec,SVN,DF,Holstein Kiel,de  Bundesliga,25-065,2000.0,9.4,12,6,9,3,0,8,10,80.0,2,20,11,9,9,21,57,2
2718,Jordan Zemura,ZIM,DF,Udinese,it  Serie A,25-117,1999.0,13.0,24,13,12,9,3,12,21,57.1,9,15,3,12,15,39,36,0
2719,Robin Zentner,GER,GK,Mainz 05,de  Bundesliga,30-134,1994.0,25.0,2,1,2,0,0,1,2,50.0,1,0,0,0,0,2,28,4
2720,Alessio Zerbin,ITA,DF,Venezia,it  Serie A,26-008,1999.0,7.0,32,17,19,8,5,18,28,64.3,10,9,2,7,9,41,11,0
2721,Alessio Zerbin,ITA,"FW,DF",Napoli,it  Serie A,26-008,1999.0,0.0,2,1,2,0,0,1,1,100.0,0,0,0,0,0,2,0,0
2722,Kevin Zeroli,ITA,MF,Monza,it  Serie A,20-059,2005.0,2.6,2,1,0,2,0,0,1,0.0,1,4,1,3,1,3,6,0
2723,Kevin Zeroli,ITA,MF,Milan,it  Serie A,20-059,2005.0,0.1,1,1,0,1,0,0,0,,0,0,0,0,0,1,0,0
2724,Cedric Zesiger,SUI,DF,Augsburg,de  Bundesliga,26-260,1998.0,6.5,5,3,4,1,0,3,4,75.0,1,9,4,5,9,14,53,1
2725,Cedric Zesiger,SUI,DF,Wolfsburg,de  Bundesliga,26-260,1998.0,5.8,13,8,6,5,2,6,12,50.0,6,6,5,1,3,16,28,0
2726,Michael Zetterer,GER,GK,Werder Bremen,de  Bundesliga,29-242,1995.0,25.0,0,0,0,0,0,0,0,,0,0,0,0,1,1,7,5
2727,Nathan Zeze,FRA,DF,Nantes,fr  Ligue 1,19-266,2005.0,11.6,26,15,13,13,0,16,23,69.6,7,18,8,10,17,43,87,0
2728,Edon Zhegrova,KVX,"FW,MF",Lille,fr  Ligue 1,25-345,1999.0,10.9,5,2,3,0,2,2,7,28.6,5,8,0,8,4,9,1,0
2729,Piotr Zieliński,POL,MF,Inter,it  Serie A,30-295,1994.0,9.3,12,8,4,7,1,6,12,50.0,6,9,4,5,6,18,11,1
2730,Oleksandr Zinchenko,UKR,"DF,MF",Arsenal,eng  Premier League,28-086,1996.0,3.3,2,0,1,1,0,1,4,25.0,3,5,0,5,3,5,5,0
2731,Joshua Zirkzee,NED,"FW,MF",Manchester Utd,eng  Premier League,23-293,2001.0,13.7,13,7,3,7,3,5,10,50.0,5,13,4,9,5,18,8,0
2732,Budu Zivzivadze,GEO,FW,Heidenheim,de  Bundesliga,31-001,1994.0,7.9,11,8,1,6,4,4,8,50.0,4,9,0,9,3,14,4,0
2733,Luc Zogbé,CIV,DF,Brest,fr  Ligue 1,19-352,2005.0,6.6,31,17,17,11,3,17,24,70.8,7,9,2,7,14,45,19,1
2734,Nadir Zortea,ITA,"FW,MF",Cagliari,it  Serie A,25-265,1999.0,21.0,23,9,12,9,2,11,25,44.0,14,5,0,5,11,34,33,2
2735,Aristide Zossou,CIV,MF,Auxerre,fr  Ligue 1,19-270,2005.0,0.2,0,0,0,0,0,0,0,,0,0,0,0,0,0,0,0
2736,Yanis Zouaoui,ALG,"DF,FW",Le Havre,fr  Ligue 1,30-244,1994.0,10.3,17,8,9,6,2,10,14,71.4,4,14,2,12,8,25,43,0
2737,Igor Zubeldia,ESP,DF,Real Sociedad,es  La Liga,27-346,1997.0,20.5,29,19,19,8,2,12,21,57.1,9,28,17,11,24,53,74,2
2738,Martín Zubimendi,ESP,MF,Real Sociedad,es  La Liga,26-037,1999.0,23.9,56,32,24,22,10,22,33,66.7,11,34,13,21,32,88,58,2
2739,Edhy Zuliani,ITA,DF,Toulouse,fr  Ligue 1,20-212,2004.0,0.1,0,0,0,0,0,0,0,,0,0,0,0,1,1,0,0
2740,Szymon Żurkowski,POL,MF,Empoli,it  Serie A,27-167,1997.0,1.2,6,4,2,4,0,4,4,100.0,0,3,0,3,1,7,2,0
2741,Martin Ødegaard,NOR,MF,Arsenal,eng  Premier League,26-084,1998.0,18.2,16,9,7,6,3,3,20,15.0,17,4,0,4,3,19,3,0
2742,Milan Đurić,BIH,FW,Monza,it  Serie A,34-293,1990.0,14.1,1,1,0,1,0,0,3,0.0,3,6,0,6,2,3,17,0
2743,Milan Đurić,BIH,FW,Parma,it  Serie A,34-293,1990.0,2.1,0,0,0,0,0,0,2,0.0,2,2,0,2,0,0,0,0
